Aabha	आभा
Aabriti	अब्रिती
Aadya	आद्या
Aadhikya	आधिक्य
Aagnya	अज्ञा
Aagya	आग्या
Aahana	अहाहा
Aaisha	आइशा
Aaishka	आशिका
Aaja	आहा
Aakanchhya	आकांछ्या
Aakreeti	आकृति
Aakritee	आकृति
Aakriti	आकृति
Aanya	आन्या
Aaradhana	आराधना
Aarati	आरती
Aarjabi	अरजाबी
Aarjani	अरजानी
Aarjawee	आरजावी
Aarju	आरजु
Aarjya	आर्ज्य
Aarshika	आर्शिका
Aarshiya	आर्शिया
Aarti	आरती
Aarya	आर्य
Aarzoo	आरजु
Aasha	आशा
Aashi	आशी
Aashisna	आशिस्ना
Aashiya	आशिया
Aashma	अश्मा
Aashriti	आश्रिती
Aashu	आशु
Aasma	अस्मा
Aastha	आस्था
Aayeesha	आयशा
Aayesha	आयशा
Aaysha	आयशा
Aayusha	आयुषा
Aayushi	आयुषी
Aayushka	आयुष्का
Aayushma	आयुष्मा
Abha	आभा
Abhigya	अभिज्ञ
Abhilasha	अभिलाषा
Abhishree	अभिश्री
Abisha	अबिशा
Abriti	अब्रिती
Ac	Ac
Ac-sah	एसी-साह
Achana	अचना
Achhami	अछामी
Adeeti	अदिती
Adhista	अधिष्ठा
Adipti	आदिप्ति
Aditi	अदिति
Adity	आदित्य
Afreen	अफ्रिन
Agya	अग्या
Aisha	ऐशा
Aishwarya	ऐश्वर्या
Aishworya	ऐश्वर्या
Ajanta	अजन्ता
Ajeena	अजिना
Ajina	अजिना
Ajita	अजिता
Akanksha	आकांक्षा
Akankshya	आकांक्षा
Akansha	आकांशा
Akreeti	अक्रिति
Akritee	अक्रिती
Akriti	आकृति
Akrity	आकृति
Akshata	अक्षता
Akshyata	अक्षया
Akshyeta	अक्षयता
Albira	अल्बिरा
Aleana	एलियाना
Aleena	एलिना
Alena	एलेना
Alfa	अल्फा
Alice	एलिस
Alija	अलिजा
Alima	अलिमा
Alina	एलिना
Alisa	एलिस
Alish	अलिश
Alisha	अलिशा
Alishma	अलिश्मा
Alita	अलिता
Aliza	अलिजा
Aljina	अल्जिना
Alka	अल्का
Alpana	अल्पना
Alpha	अल्फा
Alvira	अलविरा
Ambika	अम्बिका
Amina	अमिना
Amira	अमिरा
Amisha	अमिषा
Amita	अमिता
Amrita	अमृता
Amshu	अम्शु
Amuda	अमुदा
Anami	अनामी
Anamika	अनामिका
Anant	अनन्त
Ananta	अनन्त
Anchal	आँचल
Aney	एनी
Ang	एङ्ग
Angana	अंगना
Angeela	एन्जेला
Angel	परी
Angela	एन्जेला
Angila	एन्जिला
Angira	अंगिरा
Angisha	अंगिशा
Angshu	आङ्शु
Anie	एनी
Anika	अनिका
Anila	अनिला
Anima	एनिमा
Anisha	अनिशा
Anishma	अनिश्मा
Anita	अनिता
Anjalee	अञ्जली
Anjali	अञ्जली
Anjana	अञ्जना
Anjani	अञ्जना
Anjeela	एन्जेला
Anjeena	अन्जिना
Anjila	अन्जिला
Anju	अन्जु
Anjula	अन्जुला
Anjuli	अन्जुली
Ankita	अंकिता
Anku	अंकु
Anmol	अनमोल
Annanta	अनन्त
Annie	एनी
Annu	एन
Anny	एनी
Anouska	अनुस्का
Anshika	अन्शिका
Anshu	अंशु
Anshumala	अंशुमाला
Ansu	अन्सु
Ansuya	अन्सुया
Answiya	उत्तर
Antima	एन्टिमा
Anu	अनु
Anugya	अनुग्या
Anuja	अनुजा
Anuka	अनुका
Anukshya	अनुक्षा
Anumeha	अनुमेहा
Anumita	अनुमिता
Anupa	अनुपा
Anupama	अनुपमा
Anupma	अनुपमा
Anupriya	अनुप्रिया
Anura	अनुरा
Anuradha	अनुराधा
Anusha	अनुशा
Anushikha	अनुशिखा
Anushiya	अनुसिया
Anushka	अनुष्का
Anushma	अनुष्मा
Anushree	अनुश्री
Anushreta	अनुश्रेता
Anushriya	अनुश्रिया
Anushruti	अनुश्रुति
Anuska	अनुष्का
Anusuya	अनुसुया
Anzoo	अन्जु
Aparajita	अपराजिता
Aparna	अपर्णा
Apechhaya	अपेछाया
Apeckchya	एपेक्या
Apekchhya	अपेक्ष्य
Apekhya	अपेख्या
Apekshya	अपेक्ष्य
Apeshhaya	अपेशाय
Apsa	अप्सा
Apsana	अप्सना
Apsara	अप्सरा
Apshara	अप्सरा
Aradhana	आराधना
Araju	आरजु
Araksha	अर्क्ष
Aranjali	अरञ्जली
Arati	आरती
Arbina	अर्बिना
Archana	अर्चना
Archita	अर्चिता
Archu	अर्चु
Arica	एरिका
Arika	अरिका
Arina	अरिना
Arishma	अरिष्मा
Arjani	अर्जनी
Arjina	अर्जिना
Arju	अर्जु
Arma	अर्मा
Armila	आर्मिला
Arnisha	अर्निशा
Arpana	अर्पण
Arshiya	अर्शिया
Arti	आरती
Aruna	अरुणा
Arunima	अरुणिमा
Arusha	आरुषा
Arya	आर्य
Aryasupurna	आर्यसुपूर्ण
Arzoo	आरजु
Asbina	अस्बिना
Asha	आशा
Ashana	आशना
Ashika	आशिका
Ashiya	आशिया
Ashma	अश्मा
Ashmeeta	अस्मिता
Ashmi	अश्मी
Ashmina	अस्मिना
Ashmita	अस्मिता
Ashna	आशना
Ashrita	आश्रिता
Ashru	आश्रु
Ashu	आशु
Ashuta	आशुता
Asira	असिरा
Askina	आस्किना
Aslesha	अस्लेशा
Asma	दम
Asmin	अस्मिन
Asmita	अस्मिता
Asphota	एस्फोटा
Astha	आस्था
Asuni	असुनी
Ava	Ava
Avashana	अवशाना
Avidha	अविधा
Avilasha	अविलाशा
Avipsa	Avipsa
Ayasha	आयशा
Ayashree	आयश्री
Ayesha	आयशा
Ayousma	आयुस्मा
Ayusha	आयुषा
Ayushi	आयुशी
Ayushma	आयुष्मा
Azzeta	एजेटा
Babi	बाबी
Babina	बबिना
Babisha	बबिशा
Babita	बबिता
Badal	बादल
Badhyata	बध्यता
Bajracharya	बज्राचार्य
Bala	बाला
Balkumari	बालकुमारी
Bandana	बन्दना
Bandanda	बन्दना
Banti	बन्ति
Barkha	बर्खा
Barsa	बार्सिलोना
Barsha	बर्षा
Barun	ब्यारोन
Baruna	बरुना
Basanti	बसन्ती
Basnet	बस्नेत
Basudha	बसुधा
Basundhara	बसुन्धरा
Bebina	बेबिना
Beebika	बिबिका
Beelinda	बिलिन्डा
Beenita	बेनिता
Beepana	बिपना
Beeva	बीवा
Belmata	बेलमाटा
Bemita	बेमिता
Beniya	बेनिया
Benjana	बेन्जामिन
Benju	बेन्जु
Benuja	बेनुजा
Bhaba	भाभा
Bhabina	भबिना
Bhabya	भाब्य
Bhadra	भाद्र
Bhagawati	भगवती
Bhagwati	भगवती
Bhakta	भक्त
Bharati	भारती
Bharosha	भरोसा
Bharti	भारती
Bhava	भव
Bhavana	भावना
Bhavya	भव्य
Bhawana	भावना
Bhawani	भवानी
Bhawna	भावना
Bhim	भीम
Bhimkala	भीमकला
Bhooma	भूम
Bhoomika	भूमिका
Bhoya	भोया
Bhubaneswari	भुवनेश्वरी
Bhumika	भुमिका
Bhuwaneshuwari	भुवनेश्वरी
Bibechana	बिबेचना
Bibha	बिभा
Bibhas	बिभास
Bibhu	बिभु
Bibhusa	बिभुसा
Bibhuti	विभूति
Bibika	बिबिका
Bibisha	बिबिशा
Bibusha	बिभुषा
Bidhata	बिद्धत
Bidhya	विद्या
Bidisha	बिदिशा
Bidita	बिदिता
Bidusi	बिदुसी
Bidya	बिद्या
Bigya	बिग्या
Bihny	बिहनी
Bijay	विजय
Bijaya	विजया
Bijayaswori	विजयेश्वरी
Bijayata	बिजयता
Bijeta	बिजेता
Bijita	बिजिता
Biju	बिजु
Bikalpa	बिकल्प
Bima	बिमा
Bimala	बिमला
Bimoo	बिमू
Bina	बिना
Binam	बिनाम
Binash	बिनश
Binaya	बिनया
Binda	बिन्द
Bindhya	बिन्ध्य
Bindira	बिन्दिरा
Bindisha	बिन्दिशा
Bindiya	बिन्दिया
Bindra	बिन्द्रा
Bindu	बिन्दु
Bindyashwori	बिन्द्येश्वरी
Binee	बिनी
Bineela	बिनाला
Bineeta	बिनीता
Bineta	बिनेता
Bini	बिनी
Binisha	बिनिशा
Binita	बिनिता
Binni	बिन्नी
Binny	बिन्नी
Binu	बिनु
Binuka	बिनुका
Bipana	बिपना
Bipasana	बिपासना
Bipasyana	बिपश्यना
Bipika	बिपिका
Bipina	बिपिना
Bipisha	बिपिशा
Biplabi	बिप्लबी
Bipsana	बिप्सना
Bipu	विपु
Bipula	बिपुला
Bishnu	विष्णु
Bishnubi	विष्णुबी
Bishruti	बिश्रुति
Bishuka	बिशुका
Bisikha	बिशिखा
Bisista	बिसिस्टा
Bismita	बिस्मिता
Bity	बिटी
Biva	बिवा
Bivusha	बिभुषा
Bodhita	बोधिता
Brabina	ब्राबिना
Brinda	वृन्दा
Brinju	ब्रिन्जु
Brishti	वृष्टि
Bristi	ब्रिस्टी
Britty	ब्रिटी
Buddhi	बुद्ध
Buki	बुकी
Bulbul	बुलबुल
Bunu	बुनु
Bushra	बुशरा
Carolin	क्यारोलिन
Chahana	चाहना
Chanchala	चंचला
Chand	चन्द
Chanda	चन्द
Chandani	चाँदनी
Chandha	चन्द
Chandika	चण्डिका
Chandni	चाँदनी
Chandra	चन्द्र
Chandrawoti	चन्द्रवती
Chandrika	चन्द्रिका
Chaneswori	चनेश्वरी
Chanu	चानु
Charitra	चरित्र
Charu	चारु
Charushree	चारुश्री
Chaudhary	चौधरी
Chaulagai	चौलागाई
Cheena	चिना
Cheli	चेली
Cherina	चेरिना
Chesta	छाती
Chet	चेट
Chetana	चेतना
Chhabi	छबी
Chhanya	छन्या
Chhatra	छत्र
Chhaya	छाया
Chhotol	छोटोल
Chinki	चिन्की
Chitra	चित्रा
Chitrakala	चित्रकला
Chrisha	क्रिशा
Christina	क्रिस्टिना
Chuna	चुना
Chunauti	चुनौती
Cimona	सिमोना
Cindy	सिन्डी
Cubie	क्युबी
Cynthia	सिन्थिया
Dagina	दागिना
Dakshina	दक्षिणा
Dakshya	दक्ष
Darshana	दर्शन
Dawadi	दवाडी
Dawajangmu	दावाजङ्मु
Debakee	देबकी
Debaki	देबकी
Deeja	डिजा
Deekchhhya	दीखछ्या
Deekep	दिप
Deeksha	दीक्षा
Deena	दीना
Deepa	दिपा
Deepali	दिपाली
Deepanjali	दिपाञ्जली
Deepika	दिपिका
Deepsana	दिपसना
Deepshikha	दीपशिखा
Deepta	दिपता
Deepti	दिप्ति
Deewa	दिवा
Depenti	निर्भर
Dev	देव
Devi	देवी
Devina	देविना
Dewaki	देवकी
Dhan	धन
Dhana	धना
Dhanita	धनिता
Dhanlaxmi	धनलक्ष्मी
Dharaatee	धराते
Dharmisara	धर्मिसरा
Dhoka	ढोका
Dhungel	ढुङ्गेल
Dibasa	दिबासा
Dibya	दिव्या
Dibyashori	दिव्यशोरी
Dibyaswari	दिव्यस्वरी
Digya	दिग्या
Dija	दिजा
Dikchhya	दिक्छ्या
Diksha	दिक्षा
Dikshita	दीक्षित
Dikshya	दिक्षा
Dil	दिल
Dilasha	डिलाशा
Dimpal	डिम्पल
Dina	दिना
Dinuka	दिनुका
Dipa	दिपा
Dipali	दिपाली
Dipika	दिपिका
Dipiksha	दिपिका
Dipinti	दिपिन्ति
Dipisha	दिपिशा
Dipta	दिप्त
Diptee	दिप्ती
Dipti	दिप्ती
Dita	दिता
Diva	दिवा
Divya	दिव्या
Diwa	दिवा
Dixa	डिक्सा
Diya	दीया
Dn	Dn
Dolma	डोल्मा
Donurashmi	डोनुराश्मी
Dr	डा
Dreeshti	द्रष्टी
Dristi	द्रष्टि
Duma	डुमा
Durga	दुर्गा
Dwa	ड्वा
Dwarika	द्वारिका
Dzivi	Dzivi
Eanjila	एन्जिला
Edina	एडिना
Eeda	ईडा
Eelisha	एलीशा
Ekata	एकता
Ekisha	एकिशा
Ekta	एकता
Eleeja	इलिजा
Eleena	एलेना
Elina	एलिना
Elisa	एलिसा
Elisha	एलीशा
Eliza	एलिजा
Emma	एम्मा
Ena	एना
Enjila	एन्जिला
Enna	अन्ना
Era	युग
Ereena	इरिना
Erena	एरेना
Erensa	एरेन्सा
Erica	एरिका
Erika	एरिका
Erina	इरिना
Erosha	इरोशा
Eru	एरु
Eshana	इशाना
Eurika	युरिका
Eva	इभा
Farina	फारिना
Farjana	फरजाना
Freza	फ्रेजा
Fungma	फङ्मा
Ganakeshari	गणकेशरी
Gandira	गान्डिरा
Ganesha	गणेश
Ganga	गंगा
Gargi	गार्गी
Garima	गरिमा
Gauri	गौरी
Gava	गवा
Gayatri	गायत्री
Geena	जीना
Geeta(lamsal)	गीता (लम्सल)
Geeta	गीता
Geetanjali	गीताञ्जली
Girija	गिरिजा
Gita	गीता
Gitanjali	गीताञ्जली
Goldi	गोल्डी
Goma	गोमा
Goshana	गोशाना
Greema	ग्रीमा
Grishma	ग्रिष्मा
Grishu	ग्रिशु
Gudiya	गुडिया
Gunawati	गुणवती
Gunja	गुन्जा
Gunjan	गुञ्जन
Gunjana	गुञ्जना
Gurung	गुरुङ
Gyani	ज्ञानी
Gyanu	ज्ञानु
Gynendra	ज्ञानेन्द्र
Hari	हरि
Harshana	हर्षना
Hasana	हसना
Hasina	हसिना
Hasna	हसना
Heema	हिमा
Heena	हिना
Helen	हेलेन
Heli	हेली
Hema	हेमा
Hemanchal	हेमाञ्चल
Hemanti	हेमन्ति
Hemantika	हेमन्तिका
Hemkala	हेमकला
Hemprabha	हेमप्रभा
Hilda	हिल्डा
Hima	हिमा
Himali	हिमाली
Himlona	हिमोना
Himshikha	हिमशिखा
Hina	हिना
Hira	हिरा
Hisi	हिसि
Hisila	हिसिला
Honey	मह
Hosanna	होसन्ना
Hritu	ऋतु
Huma	हुमा
Ichchha	इच्छा
Ichchu	इच्छा
Ichhaya	इच्छा
Ichhya	इच्छा
Iebu	जेबु
Iha	इहा
Ila	इला
Ilashree	इलाश्री
Imona	इमोना
Ina	मा
Indira	इन्दिरा
Indra	इन्द्र
Indu	इन्दु
Ingita	इन्जिटा
Inita	इनिता
Insha	इन्शा
Inshiya	इन्सिया
Inu	इनु
Ira	इरा
Irada	इराडा
Irina	इरिना
Iru	इरु
Isabel	इसाबेल
Isha	ईशा
Ishani	ईशानी
Ishara	इशारा
Ishu	इशु
Ishwori	ईश्वरी
Ivaa	Ivaa
Jagat	जगत
Jagina	जगिना
Jagriti	जागृति
Jainish	जैनिश
Jampa	जाम्पा
Jamuna	जमुना
Janaki	जानकी
Janani	जननी
Janemoon	जेनेमुन
Januka	चानुकाह
Japanika	जापानिका
Japsana	जाप्सना
Jareena	जरिना
Jashmina	चमेली
Jasmeen	चमेली
Jasmin	जैस्मिन
Jasmina	चमेली
Jasmine	चमेली
Jawala	जावला
Jawani	जवानी
Jaya	जय
Jayanti	जयन्ती
Jayata	जयता
Jayshree	जयश्री
Jeebika	जिबिका
Jeena	जीना
Jeewasmi	जीवास्मि
Jenesha	जनेशा
Jeneshree	जेनेश्री
Jeni	जेनी
Jenisha	जेनिशा
Jenita	जेनिता
Jeniya	जेनिया
Jenny	जेनी
Jenu	जेनु
Jeny	जेनी
Jessica	जेसिका
Jharana	झरना
Jharna	झरना
Jhuna	झुना
Jiban	जीवन
Jigeesha	जिगेशा
Jigyasha	जिज्ञासा
Johny	जोनी
Jolly	जोली
Joshi	जोशी
Joshika	जोशीका
Joshna	जोश्ना
Joshua	जोशुआ
Juhi	जुही
Juli	जुलाई
Julia	जुलिया
Julu	जुलाई
Jun	जुन
Juna	जुन
June	जुन
Junee	जुनी
Juni	जुन
Junika	जुनिका
Junita	जुनिता
Junu	जुन
Jwala	ज्वाला
Jyashmine	ज्याश्मीन
Jyonita	ज्योनिता
Jyoti	ज्योति
Jyotir	ज्योतिर्
Jyotirma	ज्योतिर्मा
Jyotsana	ज्योत्सना
Jyotsna	ज्योत्स्ना
Kabina	केबिन
Kabisha	कबिशा
Kabita	कविता
Kajal	काजल
Kajol	काजोल
Kala	काला
Kalawati	कलावती
Kalayani	कल्याणी
Kalina	कालिना
Kalpalata	कल्पलता
Kalpana	कल्पना
Kalyani	कल्याणी
Kamala	कमला
Kamana	कामना
Kamini	कामिनी
Kanchan	कञ्चन
Kanchana	कञ्चना
Kanchanmala	कञ्चनमाला
Kanti	कान्ति
Kareena	करिना
Karishma	करिश्मा
Karn	कर्ण
Karuna	करुणा
Kashish	कशिश
Kasturi	कस्तुरी
Katyayani	कात्यायनी
Kaushalya	कौशल्या
Kaveri	कावेरी
Kavita	कविता
Kavre	काभ्रे
Kenopama	केनोपामा
Kenu	केनु
Kerina	केरिना
Keron	केरोन
Kesha	केशा
Keshab	केशव
Keshabati	केशवती
Keshika	केशिका
Kesina	केसिना
Keyur	केयुर
Khadka	खड्का
Khalida	खालिदा
Khanal	खनाल
Khatiwada	खतिवडा
Khooshbu	खुस्बु
Khusboo	खुस्बु
Khusbu	खुस्बु
Khushboo	खुश्बु
Khushbu	खुश्बु
Kinta	किन्टा
Kipa	किपा
Kiran	किरण
Kirtan	कीर्तन
Kirti	कीर्ति
Kirty	किर्ती
Kishori	किशोरी
Kitu	कितु
Komal	कोमल
Kopila	कोपिला
Kosmita	कोस्मिता
Kranti	क्रान्ति
Kreeti	क्रेट
Kribina	कृबिना
Kripa	कृपा
Krisha	कृषा
Krishma	कृष्ण
Krishna	कृष्ण
Krishnaa	कृष्ण
Krishtina	कृष्णा
Krista	क्रिस्टा
Kristina	क्रिस्टिना
Kritee	कृति
Kriti	कृति
Kritika	आलोचना
Kritina	कृतिना
Kritisa	कृतिसा
Kritisha	कृतिशा
Krity	कृति
Kshamata	क्षमाता
Kshitij	क्षितिज
Kshitiz	क्षितिज
Kshyamata	क्ष्यामाता
Kukee	कुकी
Kumari	कुमारी
Kumud	कुमुद
Kumudini	कुमुदिनी
Kusha	कुशा
Kushalta	कुशलता
Kushma	कुश्मा
Kushmawati	कुष्मावती
Kushmita	कुश्मिता
Kushum	कुसुम
Kusmita	कुस्मिता
Kusum	कुसुम
Labina	लबिना
Lachana	लचना
Lachhen	लछेन
Laghumee	लघुमी
Laila	लैला
Lajana	लजना
Lakpa	लाक्पा
Lakshyapurna	लक्ष्यपूर्ण
Lal	लाल
Lalita	ललिता
Lanka	लंका
Lasata	लसाता
Lata	लता
Latika	लतिका
Laxmi(gautam)	लक्ष्मी (गौतम)
Laxmi	लक्ष्मी
Leeja	लीजा
Leela	लीला
Leena(shrestha)	लीना (श्रेष्ठ)
Leena	लीना
Leepi	लिपी
Leeza	लीजा
Lekha	लेखा
Lena	लेना
Lezina	लेजिना
Lhakpa	लाक्पा
Lijeena	लिजिना
Lila	लिला
Lili	लिली
Lilian	लिलियन
Lilu	लिलु
Lina	लिना
Linda	लिन्डा
Lisa	लिसा
Lisha	लिशा
Liva	लिभा
Liway	लिवे
Liyan	लियान
Liza	लिजा
Lizina	लिजिना
Lizna	लिज्ना
Lochan	लोचन
Lok	लोक
Loomila	लुमिला
Lucy	लुसी
Lujina	लुझिना
Lumanti	लुमन्ती
Lumnima	लुम्निमा
Luna	लुना
Lunibha	लुनिभा
Luniva	लुनिभा
Lushan	लुशन
Luza	लुजा
Mabina	मबिना
Madalasa	मदालसा
Madhavi	माधवी
Madhu	मधु
Madhumala	मधुमाला
Madhuri	माधुरी
Madhurima	मधुरिमा
Mahalaxmi	महालक्ष्मी
Mahamaya	महामाया
Maharjan	महर्जन
Maheshwori	महेश्वरी
Mahima	महिमा
Maiy	माई
Maiya	माया
Mala	माला
Malati	मालती
Malika	मलिका
Malisha	मलिशा
Mallika	मल्लिका
Mamata	ममता
Mamina	मोमिना
Mamita	ममिता
Mamta	ममता
Man	मान्छे
Manaandiny	मानन्दिनी
Manabi	मनाबी
Manali	मनाली
Manara	मनारा
Manasha	मनशा
Manasi	मानसी
Manaswi	मनस्वी
Mandira	मन्दिरा
Maneesha	मनिषा
Manika	मनिका
Manikala	मणिकाला
Manila	मनिला
Manisa	मनिसा
Manisha	मनिषा
Manistha	मनिष्ट
Manita	मनिता
Manjeeta	मन्जिता
Manjila	मञ्जिला
Manjita	मञ्जिता
Manju	मञ्जु
Manjula	मञ्जुला
Manjuswari	मञ्जुस्वरी
Mantee	मन्टी
Manu	मनु
Marisha	मारिशा
Martina	मार्टिना
Mary	मेरी
Matina	माटिना
Mausam	मौसम
Maya	माया
Mayuri	मयुरी
Medha	मेधा
Meelisha	मीलिशा
Meen	अर्थ
Meena	मीना
Meenakshi	मिनाक्षी
Meenali	मीनाली
Meera	मीरा
Meeta	मिता
Megha	मेघा
Meghna	मेघना
Melanie	मेलानी
Melina	मेलिना
Melisha	मेलिसा
Menaka	मेनका
Menuka	मेनुका
Merina	मेरिना
Merishna	मेरिश्ना
Merry	रमाइलो
Meryina	मरिना
Meshuka	मेसुका
Migma	मिग्मा
Miki	मिकी
Mikky	मिकी
Mila	मिला
Milan	मिलान
Mili	मिलि
Milli	मिलि
Milu	मिलु
Mimamsa	मिमांसा
Mina	मिना
Minakshi	मिनाक्षी
Mingma	मिङ्मा
Minoda	मिनोडा
Minu	न्यूनतम
Mira	मिरा
Misan	मिसन
Mission	मिशन
Mithila	मिथिला
Mitu	मितु
Mona	मोना
Monalisa	मोनालिसा
Monalisha	मोनालिशा
Moni	मोनी
Monica	मोनिका
Monika	मोनिका
Monima	मोनिमा
Monisma	मोनिज्म
Monu	मोनु
Moon	चन्द्रमा
Moti	मोती
Mounata	मोनाटा
Mousami	मौसमी
Mridu	मृदु
Mudita	मुदिता
Mugdha	मुग्धा
Mukta	मुक्ता
Muna	मुना
Munal	मुनाल
Muney	पैसा
Muni	मुनि
Muskan	मुस्कान
Nabina	नबिना
Nabinba	नबिनबा
Nabita	नविता
Nagina	नगिना
Naina	नैना
Nainisha	नैनिशा
Najma	नजमा
Namasya	नमस्य
Namika	नामिका
Namina	नमिना
Namita	नमिता
Namrata	नम्रता
Namu	नमु
Namuna	नमुना
Nancy	न्यान्सी
Nandani	नन्दनी
Nandini	नन्दिनी
Nani	नानी
Nanju	नान्जु
Nanu	नानु
Nanumaya	नानुमाया
Narayani	नारायणी
Nasala	नासाला
Nashibha	नशिभा
Nashila	नाशिला
Nashiva	नाशिवा
Nashla	नश्ला
Naswa	नस्वा
Nataliya	नतालिया
Natasha	नताशा
Navanita	नवनिता
Nayanshi	नयनशी
Nebula	नेबुला
Neela	नीला
Neelam	नीलम
Neelima	निलिमा
Neelu	निलु
Neera(shreshtha)	नीरा (श्रेष्ठ)
Neera	नीरा
Neeru	निरु
Neesha	निशा
Neeta	नीता
Neeti	नीति
Neetu	नीतु
Neeyanta	नियन्त
Neha	नेहा
Neliya	नेलिया
Nensi	न्यान्सी
Nerina	नेरिना
Newkit	न्यूकिट
Ngim	Ngim
Nhasala	नशाला
Nicky	निकी
Nidhi	निधि
Niharika	निहारिका
Niju	निजु
Nikee	नाइके
Niki	निकी
Nikila	निकिला
Nikisha	निकिशा
Nikita	निकिता
Nikki	निक्की
Niku	निकु
Niky	निकी
Nil	शून्य
Nilam	नीलम
Nilima	निलिमा
Nilisha	निलिशा
Nilishma	निलिश्मा
Nilu	निलु
Nima	निमा
Nimisha	निमिषा
Nimmi	निम्मी
Nina	नीना
Nipuna	निपुना
Nira	निरा
Niraj	निरज
Nirala	निराला
Niramika	निर्मिका
Niranjala	निरञ्जला
Niranjali	निरञ्जली
Niranjana	निरञ्जना
Nireesha	निरिशा
Nirjala	निर्जला
Nirjana	निर्जना
Nirmala	निर्मला
Nirmaya	निर्मया
Nirmisha	निर्मिषा
Niroula	निरौला
Niru	निरु
Nirupa	निरुपा
Nirupam	निरुपम
Nirupama	निरुपमा
Nirusha	निरुषा
Niruta	निरुता
Nirwachan	निर्वाचन
Nisha	निशा
Nishar	निशार
Nishee	निशी
Nishi	निशी
Nishla	निश्ला
Nishma	निश्मा
Nishtha	निष्टा
Nishu	निशु
Nista	निस्ता
Nistha	निस्ता
Nita	नीता
Niti	नीति
Nitika	नितिका
Nitin	नितिन
Nitisha	नितिशा
Nitu	नितु
Niva	निवा
Niveeta	निवेता
Nivida	निविदा
Niyanta	नियन्त
Niyukti	नियुक्ति
Noopur	नूपुर
Noorja	नूरजा
Noorma	नुरमा
Norin	नोरिन
Norina	नोरिना
Nova	नोभा
Nujhat	नुजात
Nutan	नूतन
Nyima	निमा
Ojashwi	ओजश्वी
Ojaswee	ओजस्वी
Ojaswi	ओजस्वी
Ojeena	ओजिना
Ojha	ओझा
Ojina	ओजिना
Om	ओम
Opsana	ओप्साना
Pabi	पबि
Pabina	पबिना
Pabita	पविता
Pabitra	पवित्रा
Padma	पद्मा
Pakigya	पाकिग्य
Palak	पलक
Palina	पालिना
Palisa	पालिसा
Palistha	पालिस्टा
Pallavi	पल्लवी
Pallawi	पल्लवी
Palpasa	पाल्पासा
Pami	पामी
Pammi	पम्मी
Pampha	पम्फा
Pancha	पञ्च
Paneru	पनेरु
Panu	पानु
Panuza	पनुजा
Pappu	पप्पु
Paras	पारस
Parbati	पार्वती
Parijat	पारिजात
Parikrama	परिक्रमा
Parikshya	परिक्षा
Parina	परिना
Parmila	परमिला
Parmita	परमिता
Parool	पासवर्ड
Parvati	पार्वती
Parwati	पार्वती
Pasang	पासाङ
Pasee	पासी
Pashupati	पशुपति
Payal	पायल
Pema	पेमा
Pemba	पेम्बा
Persia	पर्सिया
Persis	पर्सिस
Phulmaya	फुलमाया
Phulu	फुलु
Pinkey	पिंकी
Pinki	पिंकी
Pinky	पिंकी
Piyusha	पियुषा
Pokhrel	पोखरेल
Ponam	पोनम
Pooja	पुजा
Poonam	पूनम
Poornima	पूर्णिमा
Poshin	पोशिन
Poudel	पौडेल
Prabasha	प्रभास
Prabha	प्रभा
Prabidhi	प्रबिधि
Prabina	प्रविना
Prabisa	प्रबिसा
Prabita	प्रविता
Pradipta	प्रदिप्ता
Pradita	प्रदिता
Pragatee	प्रगती
Pragati	प्रगति
Pragya	प्रज्ञा
Praja	प्रजा
Prajakti	प्राजक्ति
Prajani	प्रजानी
Prajapati-shanti	प्रजापति शान्ति
Prajeena	प्रजिना
Prajina	प्रजिना
Prajita	प्रजिता
Praju	प्राजु
Prajwala	प्रज्वाला
Prakeeti	प्रकीति
Prakirna	प्रकिर्ण
Prakritee	प्रकृति
Prakriti	प्रकृति
Prama	प्रमा
Pramila	प्रमिला
Pramina	प्रमिना
Pramisha	प्रमिषा
Pramistha	प्रमिष्ठ
Pramita	प्रमिता
Prana	प्राण
Pranika	प्रणिका
Pranisha	प्रनिशा
Pranita	प्रणिता
Prapooja	प्रपूजा
Praptee	प्राप्ती
Prapti	प्राप्ति
Prarthana	प्रार्थना
Prasamsa	प्रसंसा
Prasamsha	प्रसंशा
Prasanna	प्रसन्न
Prasansha	प्रसंशा
Prasha	प्रशा
Prashamsa	प्रशम्सा
Prashamsha	प्रशम्शा
Prashanna	प्रशन्ना
Prashansa	प्रशांस
Prashila	प्रशिला
Prashna	प्रशना
Prasiddhee	प्रसिद्धि
Prastika	प्रास्तिका
Prasun	प्रसुन
Prasuna	प्रसुना
Prateeksha	प्रतिक्षा
Prathana	प्राथना
Prathiva	पृथ्वी
Pratibha	प्रतिभा
Pratichha	प्रतिछा
Pratichhya	प्रतिज्ञा
Pratigya	प्रतिज्ञा
Pratigyan	प्रतिज्ञान
Pratik	प्रतीक
Pratika	प्रतिका
Pratikchhya	प्रतिक्षा
Pratiksha	प्रतिक्षा
Pratikshya	प्रतिक्षा
Pratima	प्रतिमा
Pratina	प्रतिना
Pratisara	प्रतिसारा
Pratisha	प्रतिशा
Pratishtha	प्रतिष्ठा
Pratistha	प्रतिष्ठा
Prativa	प्रतिभा
Pratyusha	प्रत्युषा
Prava	प्रवा
Pravakar	प्रभाकर
Praveshika	प्रवेशिका
Prayukti	प्रयुक्ति
Prazeeta	प्रजिता
Preeti	प्रीति
Preetina	प्रीतिना
Preety	प्रीति
Preity	प्रीति
Preja	प्रेजा
Preju	प्रेजु
Prekchha	प्रेक्षा
Preksha	प्रेक्षा
Prekshya	प्रेक्षा
Prelisa	Prelisa
Prem	प्रेम
Prema	प्रेमा
Prerana	प्रेरणा
Prerika	प्रेरिका
Prerna	प्रेरणा
Preshika	प्रेशिका
Prija	प्रिजा
Prinska	प्रिन्स्का
Prinyanka	प्रियंका
Prishma	प्रिष्मा
Prita	प्रिया
Pritee	प्रिती
Pritha	पृथा
Prithula	पृथुला
Priti	प्रिति
Pritina	प्रितिना
Prity	प्रिटी
Priya	प्रिया
Priyam	प्रियम
Priyambada	प्रियम्बादा
Priyana	प्रियाना
Priyanka	प्रियंका
Priza	प्रिजा
Profita	लाभ
Proshika	प्रोशिका
Publina	पब्लिना
Puja	पुजा
Pujan	पुजन
Pujita	पुजिता
Punam	पुनम
Punima	पुनिमा
Punita	पुनिता
Purna	पूर्ण
Purnima	पूर्णिमा
Pushpa	पुष्पा
Pushpanjali(khanal)	पुष्पाञ्जली (खनाल)
Pushpanjali	पुष्पाञ्जली
Puspa	पुष्पा
Quereena	क्वेरिना
Quree	कुरी
Rabab	रबाब
Rabina	रबिना
Rabindra	रवीन्द्र
Rabita	रबिता
Rachana	रचना
Rachita	रचिता
Radha	राधा
Radhika	राधिका
Ragani	रागानी
Ragina	रागिना
Rahima	रहिम
Rahisha	राहिशा
Rahita	रहिता
Rai	राई
Raihana	राईहाना
Raisha	राइशा
Rajan	राजन
Rajana	राजना
Rajani	रजनी
Rajati	रजति
Rajbhandari	राजभण्डारी
Rajeena	राजिना
Rajeeta	राजिता
Rajeshwori	राजेश्वरी
Rajina	राजिना
Rajisha	राजिशा
Rajita	रजिता
Rajiya	राजिया
Rajja	राजा
Rajju	राजु
Rajkarnikar	राजकर्णिकार
Rajshree	राजश्री
Rajya	राज्य
Rajyaswori	राज्येश्वरी
Rakhi	राखी
Rakita	रकिता
Raksha	रक्षा
Rakshya	रक्षा
Ram	राम
Rama	रामा
Rameshori	रामेश्वरी
Rami	रामी
Ramila	रमिला
Ramina	रमिना
Ramisa	रामिसा
Ramisha	रमिशा
Ramita	रमिता
Rananee	रानानी
Ranjana	रञ्जना
Ranjeeta	रञ्जिता
Ranjita	रञ्जिता
Ranju	रञ्जु
Ranu	रानु
Ranzeeta	रणजीता
Rara	रारा
Rasa	रस
Rasana	रसना
Rashee	राशी
Rashika	रसिका
Rashila	रशिला
Rashmi	रश्मि
Rashmina	रश्मिना
Rashmita	रश्मिता
Rashna	रसना
Rasika	रसिका
Rasla	रसला
Rasmi	आधिकारिक
Rasmina	रस्मिना
Rasmita	रस्मिता
Rasna	रसना
Rastriyata	राष्ट्रियता
Rasu	रसु
Rati	रति
Ratna	रत्न
Raveena	रविना
Raxchaya	रक्सचाय
Rayzeena	रेजिना
Rebecca	रेबेका
Rebika	रेबेका
Rebina	रेबिना
Reecha	रिचा
Reeju	रिजु
Reekina	रेकिना
Reema	रीमा
Reena	रीना
Reenu	रेनु
Reeta	रीता
Reetu	रितु
Reeya	रिया
Regan	रेगन
Regina	रेजिना
Rehana	रेहाना
Rejina	रेजिना
Rekha(kandel)	रेखा (कँडेल)
Rekha	रेखा
Renisha	रेनिशा
Renu	रेणु
Renuka	रेणुका
Reny	रेनी
Resa	रेसा
Resha	रेशा
Reshma	रेश्मा
Reshmi	रेश्मी
Reshu	रेशु
Resma	रेस्मा
Rheecha	रिचा
Rhitika	ऋतिक
Ribha	रिभा
Richa	रिचा
Riddhi	रिद्धि
Riha	रिहा
Rijana	रिजना
Rijita	रिजिता
Riju	रिजु
Rikita	रिकिता
Rima	रिमा
Rimsa	रिम्सा
Rina	रिना
Rinisha	रिनिशा
Rinkal	रिंकल
Rinku	रिंकु
Rinu	रिनु
Rinusha	रिनुषा
Ripala	रिपाला
Rishika	ऋषिका
Rishma	रिश्मा
Rishta	रिश्ता
Risna	रिस्ना
Rista	रिस्टा
Rita	रिता
Riti	रिति
Ritika	रितिका
Ritu	रितु
Riva	रिभा
Riya	रिया
Riyanka	रियान्का
Rmila	र्मिला
Robeena	रोबिना
Rochi	रोची
Rodina	रोडिना
Rohana	रोहाना
Rohini	रोहिणी
Roisha	रोइशा
Roj	रोज
Roja	रोजा
Rojala	रोजला
Rojana	रोजना
Rojari	रोजरी
Rojee	रोजी
Rojeena	रोजिना
Roji	रोजी
Rojin	रोजिन
Rojina	रोजिना
Rojita	रोजिता
Roju	रोजु
Roma	रोमा
Romantika	रोमान्स
Romi	रोमी
Romila	रोमिला
Romina	रोमिना
Romita	रोमिता
Rona	रोना
Ronika	रोनिका
Roomi	रुमी
Rosa	रोजा
Rose	गुलाफ
Roseleen	रोसेलिन
Rosha	रोशा
Roshana	रोशना
Roshanee	रोशनी
Roshani	रोशनी
Roshe	रोसे
Rosheela	रोशीला
Roshi	रोशी
Roshika	रोशिका
Roshila	रोशिला
Roshina	रोशिना
Roshita	रोशिता
Roshna	रोशना
Roshni	रोशनी
Rosina	रोजिना
Rossy	रोसी
Rosy	गुलाबी
Rubbi	रुबी
Rubi	रुबी
Rubika	रुबिका
Rubina	रुबिना
Ruby	रुबी
Ruchi	रुची
Ruchika	रुचिका
Ruja	रुजा
Rujeena	रुजीना
Rujha	रुझा
Ruji	रुजी
Ruju	रुजु
Rujula	रुजुला
Rukmani	रुक्मणी
Rukmina	रुक्मिना
Rukmini	रुक्मिणी
Rukmita	रुक्मिता
Rukshana	रुक्साना
Rukshar	रुक्षर
Rukuma	रुकुमा
Rumi	रुमी
Runa	रुना
Rupa	रुपा
Rupana	रुपना
Rupashi	रुपसी
Rupika	रुपिका
Rupisha	रुपिशा
Ruprama	रुपरामा
Rusha	रुशा
Ruska	रूस
Saba	साबा
Sabana	सबाना
Sabanam	सबनम
Sabbu	सब्बु
Sabhyata	सभ्यता
Sabi	सबी
Sabina	सबिना
Sabita	सविता
Sabitri	सावित्री
Sabiya	सबिया
Sabnam	सबनम
Sabreena	सबरीना
Sabrina	सबरीना
Sabu	साबु
Sacchita	सचिता
Sachchida	सच्चीदा
Sachchu	सच्चु
Sachina	सचिन
Sachita	सचिता
Sadeepta	सदिप्ता
Sadhana	साधना
Sadhiksha	साधिका
Sadhuka	साधुका
Sadichchha	सदिच्छा
Sadichha	सदिच्छा
Sadichhya	सदिच्छा
Sadichya	सदिच्य
Sadiksha	सदीक्षा
Sadikshya	सदिक्षा
Sadima	सादिमा
Sadina	सदिना
Sagina	सागिनाव
Sagun	सगुन
Sahana	सहाना
Sahanshila	सहशीला
Sahansila	सहन्सिला
Sahara	सहारा
Saharsha	सहर्ष
Sahera	साहेरा
Sahidi	सहिद
Sahina	साहिना
Sahishnu	सहिष्णु
Sahisna	सहिसना
Sahitya	साहित्य
Sajada	सजादा
Sajala	सजला
Sajan	सजन
Sajana	सजना
Sajani	सजनी
Sajeena	सजिना
Sajina	सजिना
Sajita	सजिता
Sajiva	सजिव
Sajja	सज्जा
Sakela	साकेला
Sakshamata	साक्षामाता
Sakshi	साक्षी
Sakuntala	शकुन्तला
Salina	सालिना
Salinda	सालिन्दा
Salipha	सलिफा
Salisna	सालिसना
Salona	सलोना
Saloni	सलोनी
Salouna	सलोना
Salu	नमस्ते
Saluja	सलुजा
Saluna	सलुना
Salvia	साल्भिया
Sama	साम
Samajhana	समाज
Saman	समन
Samana	सामना
Samantha	सामन्था
Samarti	समर्थी
Samata	समता
Sambhavi	सम्भावी
Sambriddhi	सम्वृद्धि
Sambridhi	सम्वृद्धि
Samee	समी
Sameeksha	समीक्षा
Sameekshya	समेक्षा
Sameera	समीरा
Sami	सामी
Samichhya	समिछा
Samichya	समिच्य
Samika	सामिका
Samikchha	समिक्छा
Samikchhya	समिक्छा
Samiksha	समिक्षा
Samikshya	समिक्षा
Samila	समिला
Samina	समिना
Samira	समिरा
Samisha	समिशा
Samita	समिता
Samixya	सामिक्स्या
Samjhan	समझ
Samjhana	सम्झना
Sampada	सम्पदा
Sampana	सम्पना
Sampanna	सम्पन्ना
Samrachana	सम्राचना
Samriddhi	समृद्धि
Samriddi	समृद्धि
Samridhi	समृद्धि
Samuna	समुना
Samundra	समुन्द्र
Samyoga	संयोग
Samyukta	संयुक्ता
Sanam	सनम
Sanaya	सनाया
Sanchita	सञ्चिता
Sanchu	साँचु
Sandeena	सन्देना
Sandeepa	सन्दिपा
Sandhya	सन्ध्या
Sandika	सन्दिका
Sandipa	सन्दिपा
Sandipta	सन्दिप्ता
Sandra	सान्ड्रा
Sangachhe	साँगाछे
Sangam	संगम
Sangeena	संगीना
Sangeeta	संगीता
Sangen	साङ्गेन
Sangina	संगिना
Sangita	संगिता
Sangya	संग्या
Sangye	सांगे
Sanima	सानिमा
Sanjana	सञ्जना
Sanjee	सञ्जी
Sanjeela	संजिला
Sanjeena	संजिना
Sanjeeta	सञ्जिता
Sanjila	संजिला
Sanjina	सन्जिना
Sanjita	सञ्जिता
Sanju	सञ्जु
Sanskriti	संस्कृत
Sansmriti	संस्कृति
Santi	सन्ती
Santoshi	सन्तोषी
Santwana	सन्ताना
Sanu	सानु
Sanyukta	संयुक्ता
Sapana	सपना
Sapkota	सापकोटा
Sapna	सपना
Sara	सारा
Sarad	सारा
Sarada	शारदा
Sarala	सरला
Saranga	सारङ्गा
Saraswati	सरस्वती
Saraswoti	सरस्वती
Sardila	सार्डिला
Sareena	सरिना
Sarika	सारिका
Sarila	सरिला
Sarina	सरिना
Sarita	सरिता
Sarju	सरजु
Sarmila	सर्मिला
Sarmistha	सर्मिष्ठा
Saroj	सरोज
Saroja	सरोजा
Sarswati	सरस्वती
Sarswoti	सरस्वती
Saru	सारा
Sarun	सरुन
Saseena	ससीना
Sashi	शशि
Sasina	ससिना
Sasita	ससिता
Satomi	सातोमी
Satya	सत्य
Saugat	सौगात
Saumya	सौम्या
Saurabhi	सौरभ
Sauravi	सौरवि
Sawana	सवाना
Sawara	सावरा
Sayara	सायरा
Sayera	सायरा
Sazina	सजिना
Sbila	सबिला
Sebi	सेबी
Sebika	सेविका
Seejal	सीजल
Seejan	सिजन
Seelu	सिलु
Seema	सीमा
Seena	सीना
Seetu	सितु
Sefina	सेफिना
Seijal	सेजल
Sejal	सेजल
Selie	सेली
Selika	सेलिका
Selina	सेलिना
Selisha	सेलिशा
Semina	सेमिना
Sepiya	सेपिया
Serene	शान्त
Sewa	सेवा
Shabnam	शबनम
Shahi	शाही
Shailaja	शैलजा
Shailaza	शैलजा
Shailika	शैलिका
Shailina	शैलिना
Shailita	शैलिता
Shailja	शैलजा
Shailshikha	शैलशिखा
Shailu	शैलु
Shairan	शायरन
Shakuntala	शकुन्तला
Shakya	शाक्य
Shaleen	शालीन
Shalini	शालिनी
Shallu	साल्लु
Shalu	शालु
Shambhabi	शम्भबी
Shambhavi	शाम्भवी
Shamin	शमिन
Shamjana	शम्जाना
Shammi	शम्मी
Shanima	शनिमा
Shanon	श्यानन
Shanta	शान्ता
Shanti	शान्ति
Shara	शारा
Sharada	शारदा
Sharda	शारदा
Sharika	शारिका
Sharishma	सरिश्मा
Sharma	शर्मा
Sharmila	शर्मिला
Sharmistha	शर्मिष्ठा
Sharon	शेरोन
Sharona	शारोना
Sharusa	शारुसा
Shayu	सायु
Sheekha	शेखा
Sheela	शीला
Sheelu	शीला
Sheetal	शितल
Sheetala	शीतला
Shefalika	शेफालिका
Sheliya	शेलिया
Sherin	शेरिन
Sheryl	शेरिल
Shewta	शेवता
Shichha	शिछा
Shichu	शिचु
Shiddi	शिद्दी
Shidi	शिदी
Shija	शिजा
Shijal	शिजल
Shikchhya	शिक्षा
Shikha	शिखा
Shiksha	शिक्षा
Shikshita	शिक्षा
Shikshya	शिक्षा
Shila	शिला
Shilata	शिलाता
Shilpa	शिल्पा
Shilu	शिलु
Shilva	शिव
Shirish	शिरीष
Shirjana	शिरजना
Shisham	शिशम
Shishu	शिशु
Shishuma	शिशुमा
Shisira	शिसिरा
Shital	शितल
Shitu	बकवास
Shiva	शिव
Shivanee	शिवानी
Shivani	शिवानी
Shiwangi	शिवांगी
Shiwani	शिवानी
Shlesha	श्लेशा
Shneha	स्नेहा
Shobha	शोभा
Shobhana	शोभना
Shova	शोभा
Shovana	शोभना
Shradda	श्राद्ध
Shraddha	श्राद्ध
Shradha	श्राद्ध
Shradhda	श्राद्ध
Shrameeka	श्रमिक
Shramina	श्रमिना
Shraswati	श्रस्वती
Shraya	श्रेया
Shree	श्री
Shreeja	श्रीजा
Shreejala	श्रीजला
Shreejana	श्रीजना
Shreeju	श्रीजु
Shreeka	श्रीका
Shreemita	श्रीमिता
Shreena	श्रीना
Shreesti	श्रेष्टी
Shreeti	श्रेति
Shreeya	श्रीया
Shreeyani	श्रेयानी
Shrefa	श्रेफा
Shrena	श्रीना
Shrestha	श्रेष्ठ
Shreya	श्रेया
Shrijali	श्रीजाली
Shrijana	श्रीजना
Shriju	श्रीजु
Shrijya	श्रीज्या
Shringa	श्रृङ्गा
Shrinija	श्रीनिजा
Shrinkhala	श्रृङ्खला
Shrisha	श्रीशा
Shrishti	सृष्टि
Shristee	सृष्टि
Shristi	सृष्टि
Shristika	सृष्टिका
Shristy	सृष्टि
Shriti	श्रीति
Shritu	श्रीतु
Shriya	श्रीया
Shroosha	श्रोशा
Shrota	श्रोता
Shruchi	श्रुची
Shrutee	श्रुती
Shruti	श्रुति
Shrutima	श्रुति
Shubha	शुभा
Shubhangi	शुभांगी
Shubhechcha	शुभेच्छ
Shubhechchha	शुभेच्छ
Shubhechhya	शुभेच्छ्या
Shubhekshya	शुभेक्ष्य
Shukti	शुक्ति
Shuprabha	शुप्रभा
Shurakshya	शुरक्षा
Shushma	सुष्मा
Shushrusha	शुश्रुषा
Shusma	सुस्मा
Shuvashna	शुवाश्ना
Shuvechchha	शुभेच्छ
Shuvee	शुभे
Shuveksha	शुभेक्षा
Shuvekshya	शुभेक्ष्य
Shweta	श्वेता
Shyamli	श्यामली
Sichu	सिचु
Siddi	सिद्दी
Sijan	सिजन
Sijapati	सिजापति
Siju	सिजु
Sikala	सिक्ला
Sikha	सिखा
Sikshya	शिक्षा
Silam	सिलम
Silika	सिलिका
Silpa	सिल्पा
Silvia	सिल्भिया
Silviya	सिल्भिया
Sima	सिमा
Simana	सिमाना
Simaran	सिमरण
Simin	सिमिन
Simona	सिमोना
Simpi	सिम्पी
Simran	सिमरन
Simron	साइमन
Sindhu	सिन्धु
Singh	सिंह
Sirapa	सिरापा
Sirijana	सिरिजाना
Sirjana	सिर्जना
Sirsha	सिरसा
Sistata	सिस्टाटा
Sistu	सिस्तु
Sita	सीता
Sital	सीतल
Sitam	सितम
Sitan	सितान
Sitashma	सीताश्मा
Sitasma	सितास्मा
Situ	सिटु
Siwangi	सिवाङ्गी
Siwani	सिवानी
Siza	सिजा
Skanda	स्कन्द
Slesa	स्लेसा
Slesha	स्लेशा
Sleshma	स्लेष्मा
Smarika	स्मारिका
Smeena	स्मीना
Smeeta	स्मिता
Smile	मुस्कान
Smiriti	स्मृति
Smirti	स्मृति
Smita	स्मिता
Smoni	स्मोनी
Smriety	स्मृती
Smrita	स्मृता
Smritee	स्मृति
Smriti	स्मृति
Sneha	स्नेहा
Snehalata	स्नेहलता
Snehi	स्नेही
Snigdha	स्निग्धा
Sobha	शोभा
Sobika	सोबिका
Sobita	शोविता
Sofia	सोफिया
Sofiya	सोफिया
Somat	सोमाट
Somee	कोही
Somi	सोमी
Somiya	सोमिया
Somkala	सोमकला
Somwati	सोमवती
Somy	सोमी
Somya	सोम्या
Sona	सोना
Sonal	सोनल
Sonalee	सोनाली
Sonali	सोनाली
Sonam	सोनम
Sonee	सोनी
Soney	सोनी
Soni	सोनी
Sonia	सोनिया
Sonika	सोनिका
Sonisha	सोनिशा
Soniya	सोनिया
Sonu	सोनु
Sonuj	सोनुज
Sonuja	सोनुजा
Sony	सोनी
Soonsoon	चाँडै
Sophiya	सोफिया
Soumya	सौम्या
Sovana	सोवना
Spandan	स्पन्दन
Spandana	स्पन्दन
Spita	स्पिता
Sraddha	श्रद्धा
Sreejana	श्रीजना
Srija	श्रीजा
Srijana	सृजना
Srijani	सृजनी
Srijila	श्रीजिला
Srijita	सृजिता
Srilina	श्रीलिना
Srisha	श्रीशा
Srishti	सृष्टि
Srista	श्रीस्ता
Sristi	सृष्टि
Sristika	सृष्टिका
Sristy	सृष्टि
Sriti	सृति
Sriyanka	श्रीयांका
Srizan	श्रीजान
Sruti	श्रुति
Stella	स्टेला
Stutee	स्टुटी
Stuti	स्तुति
Subariti	सुबारीति
Subarna	सुवर्णा
Subba	सुब्बा
Subechha	सुबेच्छा
Subeksha	सुबेक्षा
Subekshya	सुबेक्षा
Subha	सुभा
Subhadra	सुभद्रा
Subhashini	सुभाषिनी
Subhechchha	सुभेच्छ
Subhechha	सुभेच्छा
Subheckshya	सुभेक्ष्य
Subhekshya	शुभेक्ष्य
Subhiksha	सुभिक्षा
Subi	सुबि
Subidha	सुविधा
Subigya	सुबिग्या
Subika	सुबिका
Subina	सुविना
Subrata	सुब्रत
Suchana	सुचना
Suchita	सुचिता
Suchitra	सुचित्रा
Sudeekshya	सुदीक्षा
Sudeshana	सुदेशना
Sudha	सुधा
Sudichha	सुदिच्छा
Sudiksha	सुदीक्षा
Sudikshya	सुदीक्षा
Sudiksya	सुदिक्षा
Sudina	सुदिना
Sudipa	सुदिपा
Sugam	सुगम
Sugandha	सुगन्धा
Suhana	सुहाना
Suhani	सुहानी
Suja	सुजा
Sujama	सुजामा
Sujan	सुजन
Sujana	सुजना
Sujata	सुजाता
Sujeeta	सुजिता
Sujila	सुजिला
Sujina	सुजिना
Sujita	सुजिता
Suju	सुजु
Sukeerti	सुकीर्ती
Sukhami	सुखामी
Sukhyati	सुख्याति
Sukirti	सुकिर्ति
Sukirty	सुकिर्ती
Sukrita	सुक्रिता
Sukriti	सुकृति
Sulata	सुलता
Sulaxana	सुलक्साना
Sulekha	सुलेखा
Sulochana	सुलोचना
Suman	सुमन
Sumana	सुमना
Sumati	सुमती
Sumee	सुमी
Sumi	सुमी
Sumikshya	सुमिक्षा
Sumina	सुमिना
Sumira	सुमिरा
Sumita	सुमिता
Sumitra	सुमित्रा
Summi	सुम्मी
Summima	सुम्मिमा
Sumnima	सुम्निमा
Sumona	सुमोना
Sun	सूर्य
Sunaina	सुनैना
Sunam	सुनम
Sunamrata	सुनम्रता
Sunanda	सुन्दा
Sunayana	सुनयना
Suneera	सुनिरा
Sunidhi	सुनिधि
Sunila	सुनिला
Sunina	सुनिना
Sunisha	सुनिशा
Sunita	सुनिता
Sunity	सुनिता
Sunmoon	सूर्यमुन
Sunny	सन्नी
Sunsun	सनसन
Suprabha	सुप्रभा
Suprapti	सुप्रप्ति
Suprava	सुप्रवा
Supreeya	सुप्रिया
Suprima	सुप्रिम
Suprina	सुप्रिना
Supriya	सुप्रिया
Surabhi	सुरभी
Surachhya	सुराछ्या
Suraksha	सुरक्षा
Surakshya	सुरक्षा
Surata	सुरत
Suravi	सुरवि
Surena	सुरेना
Surendra	सुरेन्द्र
Suruchi	सुरुचि
Surya	सुर्य
Suryashwori	सूर्येश्वरी
Susa	सुसा
Susan	सुसान
Sushama	सुष्मा
Sushana	सुशाना
Sushanta	सुशान्त
Sushila	सुशीला
Sushma	सुष्मा
Sushmi	सुष्मी
Sushmita	सुस्मिता
Sushna	सुष्ना
Sushrita	सुश्रीता
Sushrusha	सुश्रुषा
Susila	सुशिला
Susma	सुस्मा
Susmi	सुस्मी
Susmita	सुस्मिता
Susmriti	सुस्मृति
Susongsha	सुसोङ्सा
Suta	सुता
Sutishna	सुतिष्णा
Suvaichchha	सुवैच्छ
Suvechha	सुवेच्छा
Suvechhaya	सुवेछाया
Suveksha	सुवेक्षा
Suvekshya	सुवेक्ष्य
Suvidya	सुविद्या
Suyasha	सुयाशा
Suyasta	सुयस्ता
Suyesha	सुयशा
Suyogya	सुयोग
Suza	सुजा
Suzeeta	सुजिता
Suzyan	सुज्यान
Swaechchha	स्वेच्छा
Swama	स्वामा
Swapnil	स्वप्निल
Swapnila	स्वप्निला
Swarina	स्वरिना
Swarnima	स्वर्णिमा
Swarupa	स्वरूपा
Swasti	स्वस्ति
Swastika	स्वस्तिक
Swastishila	स्वस्तिशिला
Swati	स्वाती
Sweachha	स्वेच्छा
Sweata	स्वेटा
Swechchha	स्वेच्छ
Swechha	स्वेच्छा
Swechhya	स्वेच्छ
Sweekriti	सप्ताहकृति
Sweesa	स्विसा
Swekchha	स्वेक्छा
Swekshya	स्वेक्ष्य
Sweshma	स्वेष्मा
Sweta	स्वेता
Swetchchhya	स्वेच्छ्या
Swidriti	स्विद्रति
Swikirti	स्विकर्ती
Swikriti	स्विकृति
Swodha	स्वोधा
Swoichha	स्विछा
Swonti	स्वान्ति
Swopnil	स्वप्निल
Swornapari	स्वर्णपरी
Swornima	स्वर्णिमा
Sworupa	स्वरूपा
Swosti	स्वस्ति
Swostina	स्वोस्टिना
Tabasum	तबस्सुम
Tafzira	तफ्जिरा
Tahira	ताहिरा
Tajana	ताजना
Tamanna	तमन्ना
Tamrakar	ताम्राकार
Tangbetani	ताङ्बेटानी
Tanisha	तनिशा
Tanu	तनु
Tanuja	तनुजा
Tanushree	तनुश्री
Tanya	तान्या
Tapaswini	तपस्विनी
Tapasya	तपस्या
Tara	तारा
Tarika	तारिका
Teel	टेल
Teena	टिना
Tejashwi	तेजस्वी
Tejaswi	तेजस्वी
Telisha	तेलिशा
Tezina	तेजिना
Thapa	थापा
Thuma	थुमा
Tika	टिका
Til	तिल
Tilasmi	तिलस्मि
Tilottama	तिलोत्तमा
Timila	तिमिला
Tina	टिना
Tindu	टिन्डु
Tinky	टिंकी
Tinu	तिनु
Tirtha	तीर्थ
Tirupati	तिरुपति
Toshika	तोशिका
Trinisha	त्रिनिशा
Tripti	त्रिप्ति
Trishala	त्रिशाला
Trishma	त्रिशमा
Trishna	तृष्णा
Trishula	त्रिशुला
Triveni	त्रिवेणी
Tulaja	तुलजा
Tulasa	तुलसा
Tulashree	तुलाश्री
Tulja	तुलजा
Tumla	तुम्ला
Tuphan	तुफान
Udichi	उदिची
Ujuma	उजुमा
Ukee	उकी
Uma	उम्मा
Umadevi	उमादेवी
Unique	अद्वितीय
Unisha	उनिशा
Unnati	उन्नति
Upama	उपमा
Upasana	उपासना
Upashana	उपासना
Upasna	उपासना
Urgena	Urgena
Urina	युरिना
Urisha	उरिशा
Urja	उर्जा
Urjana	उर्जना
Urmee	उर्मी
Urmila	उर्मिला
Urusha	उरुषा
Usha	उषा
Ushmita	उष्मिता
Ushnish	उष्णिश
Usmita	उस्मिता
Utkarshaa	उत्कर्ष
Utshree	उत्श्री
Utsukta	उत्सुक्त
Utsula	Utsula
Uttama	उत्तम
Uzabi	उजाबी
Vaishnavi	वैष्णवी
Vandita	वन्दिता
Vhima	भिमा
Vibha	विभा
Victory	विजय
Vidhi	विधी
Vidya	विद्या
Vineeta	विनीता
Vishruta	विश्रुता
Weenita	वीनिता
Yachana	यचना
Yaju	यजु
Yakami	याकामी
Yamuna	यमुना
Yanggi	याङ्गी
Yangi	याङ्गी
Yangjy	याङजी
Yangzom	याङजोम
Yanjee	यान्जी
Yasha	यश
Yashana	यशना
Yashasa	यशसा
Yashmi	याश्मी
Yashoda	यशोदा
Yashu	यशु
Yashuna	यशुना
Yasmine	यास्मिन
Yasoda	यासोदा
Yatra	यात्रा
Yengina	येङ्गिना
Yeshika	येशिका
Yogita	योगिता
Yojana	योजना
Yoshika	योशिका
Yubika	युबिका
Yujala	युजला
Yuki	युकी
Yukti	युक्ति
Yuna	युना
Yunika	युनिका
Yunisha	युनिशा
Yurika	युरिका
Yushma	युष्मा
Yusna	युस्ना
Yuva	युवा
Zeni	जेनी
Zenisha	जेनिशा
Aabhas	आभास
Aabhash	आभास
Aabhesh	आभेश
Aabhusan	आभूषण
Aabhushan	आभूषण
Aabish	अबिस
Aabiskar	अबिस्कर
Aadarsh	आदर्श
Aadarsha	आदर्श
Aadesh	आदेश
Aadil	आदिल
Aadip	आदिप
Aadish	अडिस
Aadit	आदित
Aaditya	आदित्य
Aafaque	अफाक
Aagat	आगत
Aaisha	आइशा
Aaju	आजु
Aakar	आकर
Aakarshan	आकार्शन
Aakash	आकाश
Aakashdip	आकाशदिप
Aakish	आकिश
Aakrish	आकृष
Aakrishta	आकृष्ट
Aakrist	अक्रिस्ट
Aakrit	आकृत
Aakritee	आकृति
Aakriti	आकृति
Aakshan	अक्षन
Aalok	आलोक
Aaman	आमान
Aamir	आमिर
Aamod	आमोड
Aamosh	आमोश
Aanal	गुदा
Aanand	आनन्द
Aananda	आनन्द
Aang	आङ
Aangnima	आङ्निमा
Aanish	अनिश
Aanshu	अंशु
Aarambh	आरम्भ
Aarati	आरती
Aarif	आरिफ
Aarjan	अर्जन
Aarogya	आरोग्य
Aarohan	हारून
Aasharam	आशाराम
Aashaya	आशया
Aashies	आशिस
Aashif	आशिफ
Aashih	आशिह
Aashik	आशिक
Aashim	आशिम
Aashiq	आशिक
Aashis	आशिस
Aashish	आशिष
Aashitosh	आशितोष
Aashma	अश्मा
Aashraf	अशरफ
Aashray	आश्रय
Aashraya	आश्रय
Aashu	आशु
Aashutoash	आशुतोस
Aashutosh	आशुतोष
Aasis	आसिस
Aasish	आशिष
Aastha	आस्था
Aastik	आस्तिक
Aasutosh	आसुतोष
Aatish	आतिश
Aatma	आत्मा
Aavaas	आभास
Aavas	अवास
Aavash	आवस
Aavishkar	आविष्कार
Aawaz	Awww
Aawish	आविस
Aayam	आयाम
Aayeesha	आयशा
Aayoush	आयुष
Aayush	आयुष
Aayusha	आयुषा
Aayushma	आयुष्मा
Aayushman	आयुष्मान
Aazad	आजाद
Abadh	अबध
Abadhesh	अबधेश
Abani	अबानी
Abanish	निरास
Abarodh	अबरोध
Abashesh	अबशेस
Abcon	Abcon
Abdhesh	अब्देश
Abdul	अब्दुल
Abdullah	अब्दुल्ला
Abdur	अब्दुर
Abdussabood	अब्दुसबुद
Abeen	अबीन
Abesh	अबेश
Abhar	अबर
Abhas	आभास
Abhash	आभास
Abhay	अभय
Abhaya	अभया
Abhayaraj	अभयराज
Abhi	अभि
Abhidan	अभिदान
Abhigya	अभिज्ञ
Abhijan	अभिजन
Abhijaya	अभिजय
Abhijeet	अभिजित
Abhijet	अभिजित
Abhijit	अभिजित
Abhik	अभिक
Abhilash	अभिलाष
Abhilasha	अभिलाषा
Abhilekh	अभिलेख
Abhilesh	अभिलेश
Abhiman	अभिमान
Abhimannu	अभिमन्नु
Abhimannyu	अभिमन्यु
Abhimanu	अभिमानु
Abhimanyu	अभिमन्यु
Abhimat	अभिमत
Abhinab	अभिनब
Abhinam	अभिनम
Abhinandan	अभिनन्दन
Abhinash	अभिनाश
Abhinashi	अभिनाशी
Abhinav	अभिनव
Abhinaw	अभिनव
Abhinay	अभिनय
Abhinaya	अभिनय
Abhinesh	अभिनेश
Abhinit	अभिनित
Abhirath	अभिरथ
Abhiru	अभिरु
Abhisek	अभिषेक
Abhisekh	अभिषेक
Abhish	अभिष
Abhishek	अभिषेक
Abhishekanand	अभिषेकन्द
Abhishekh	अभिषेक
Abhishes	अभिषेक
Abhishesh	अभिषेश
Abhishrii	अभिश्री
Abhishwor	अभिश्वर
Abhiskar	अभिस्कर
Abhiyan	अभियान
Abhiyush	अभियुष
Abhushan	आभूषण
Abhya	अभ्या
Abi	अबी
Abichar	अभिचार
Abid	अबिद
Abidh	अबिध
Abidit	अबिदित
Abijit	अभिजित
Abilash	अभिलाश
Abiman	अभिमान
Abin	अबिन
Abinab	अबिनाब
Abinash	अविनाश
Abinashi	अबिनाशी
Abinath	अभिनाथ
Abindra	अबिन्द्र
Abinish	अविनाश
Abiral	अबिरल
Abirbhav	अभिरभाव
Abisek	अबिसेक
Abisekh	अबिसेख
Abish	अबिस
Abishec	अभिषेक
Abishek	अभिषेक
Abishesh	अभिषेश
Abishkar	अबिशकर
Abiskar	अबीस्कर
Abit	अलिकति
Ablok	ब्लक
Abnish	Abnish
Abodh	अबोध
Abraham	अब्राहम
Absar	अबसार
Acchyut	अच्युत
Achal	अचल
Achalshail	अचलशैल
Acharya	आचार्य
Achiyut	अच्युत
Achut	अच्युत
Achutam	अच्युतम
Achyot	अच्योत
Achyut	अच्युत
Achyuta	अच्युता
Achyutam	अच्युतम
Active	सक्रिय
Adarsh	आदर्श
Adarsha	आदर्श
Adesh	आदेश
Adhar	अधर
Adheesh	अधेस
Adhikar	अधिकारी
Adhikari	अधिकारी
Adhip	अधिप
Adhiraj	अधिराज
Adhish	अधीश
Adida	एडिडास
Adish	आदिश
Adist	एडिस्ट
Adit	आदित
Aditi	अदिति
Aditya	आदित्य
Adwait	प्रतीक्षा
Adwitiya	अद्वितिया
Aelish	एलिस
Aeron	एरोन
Afjal	अफजल
Afroj	अफरोज
Aftab	अफताब
Afzal	अफजल
Agaman	आगमान
Agastya	अगस्त्य
Agni	अग्नि
Agnidhar	अग्निधर
Agrahari	अग्रहरी
Agraj	अग्रज
Agreem	सहमत
Agrim	एग्रीम
Ahamad	अहमद
Ahmed	अहमद
Ahsit	अहसित
Ai	ऐ
Ain	ऐन
Aisha	ऐशा
Aishorya	ऐश्वर्या
Aising	आइसिङ
Ajad	अजद
Ajaj	अजज
Ajar	अजर
Ajay	अजय
Ajaya	अजय
Ajeeb	अजिव
Ajeet	अजित
Ajeev	अजिव
Ajendra	अजेन्द्र
Ajesh	अजेश
Ajeya	अजेय
Ajib	अजिब
Ajijul	अजिजुल
Ajindra	अजिन्द्र
Ajit	अजित
Ajita	अजिता
Ajitesh	अजितेश
Ajmat	अजमत
Ajoy	अजोय
Ajul	अजुल
Ajya	अज्या
Akal	अकाल
Akalesh	अकालेश
Akarshan	अकर्षन
Akash	आकाश
Akashdip	आकाशदीप
Akbal	अकबल
Akendra	अकेन्द्र
Akesh	अकेश
Akhalesh	अखलेश
Akhanda	अखण्ड
Akhatar	अख्तर
Akhil	अखिल
Akhilesh	अखिलेश
Akhileshwar	अखिलेश्वर
Akhlaque	अखलाक
Akikaran	अकिकरण
Akil	अखिल
Akkal	अक्कल
Aklesh	अक्लेश
Akramul	अक्रमुल
Akrish	अक्रिस
Akrit	अक्रित
Akshar	अक्षर
Akshay	अक्षय
Akshaya	अक्षय
Akshya	अक्षय
Alam	आलम
Alan	एलन
Alankar	अलङ्कर
Alash	अलास
Albij	अल्बिज
Albin	अल्बिन
Alek	एलेक
Alekh	अलेख
Alen	एलेन
Alence	एलेन्स
Alex	एलेक्स
Alexi	एलेक्सी
Alfaz	अल्फाज
Ali	अली
Alice	एलिस
Alija	अलिजा
Alina	एलिना
Alis	एलिस
Alish	अलिश
Alisha	अलिशा
Alishma	अलिश्मा
Aliz	एलिज
Aliza	अलिजा
Aljan	अल्जान
Aljina	अल्जिना
Alkaraj	अल्काराज
Alkesh	अल्केश
Allan	एलन
Allon	एलोन
Almin	अल्मिन
Aloj	आलोज
Alok	आलोक
Aloke	नमस्ते
Alora	अलोरा
Alson	साथै
Altaf	अल्ताफ
Alwin	अल्विन
Amal	अमल
Amalendu	अमलेन्दु
Aman	एउटा मान्छे
Amanul	अमानुल
Amar	अमर
Amardeep	अमरदीप
Amardip	अमरदीप
Amarendra	अमरेन्द्र
Amaresh	अमरेश
Amarjeet	अमरजीत
Amarnath	अमरनाथ
Amatya	अमात्य
Ambar	एम्बर
Ambaris	अम्बारीस
Amber	एम्बर
Ambesh	अम्बेश
Ambika	अम्बिका
Ambikesh	अम्बिकेश
Ambish	अम्बिश
Ambrish	अम्ब्रिस
Ameer	अमिर
Ameresh	अमरेश
Amien	आमेन
Amik	अमिक
Amin	आमेन
Amina	अमिना
Amindra	अमिन्द्र
Amir	अमिर
Amiri	अमिरी
Amirinarayan	अमिरनारायण
Amish	अमिस
Amishan	अमिशन
Amit	अमित
Amita	अमिता
Amitab	अमिताब
Amitabh	अमिताभ
Amitananda	अमितानन्द
Amlesh	अमलेश
Amnish	अमनीश
Amod	आमोड
Amoda	अमोडा
Amogh	अमोघ
Amogha	अमोघा
Amol	अमोल
Amool	अमोल
Amosh	आमोश
Amrambha	अमरंभ
Amrendra	अमरेन्द्र
Amresh	अमरेश
Amrish	अमरिश
Amrit	अमृत
Amrita	अमृता
Amtesh	अमटेश
Amul	अमूल
Amulya	अमुल्य
Amun	अमुन
Anamika	अनामिका
Anamol	अनमोल
Anand	आनन्द
Ananda	आनन्द
Ananga	अनंगा
Anankit	अनंकित
Anant	अनन्त
Ananta	अनन्त
Anarullah	अनरुल्लाह
Anav	अनाव
Anbi	अन्बी
Anchal	आँचल
Andolan	आन्दोलन
Andrew	एन्ड्रयू
Andy	एन्डी
Aneesh	अनिश
Aneet	अनित
Anendra	एनेन्द्र
Anesh	अनेश
Ang	एङ्ग
Anga	अंगा
Angad	अंगद
Angal	अंगल
Angash	अंगाश
Angel	परी
Angela	एन्जेला
Angishor	अंगिसोर
Angkit	अंकित
Angnima	अंगिमा
Angur	अंगुर
Anib	अनिब
Anij	अनिज
Aniket	अनिकेत
Anikit	अनिकित
Anil	अनिल
Anima	एनिमा
Animesh	अनिमेष
Anin	अनिन
Anindya	अनिन्द
Anir	अनिर
Anirodh	अनिरोध
Anirudh	अनिरुद्ध
Anirudra	अनिरुद्र
Anis	अनिस
Anish	अनिश
Anisha	अनिशा
Anit	अनित
Anita	अनिता
Anjal	अन्जल
Anjalee	अञ्जली
Anjali	अञ्जली
Anjan	अन्जन
Anjana	अञ्जना
Anjani	अञ्जना
Anjay	अञ्जय
Anjaya	अञ्जय
Anjeena	अन्जिना
Anjeep	अन्जिप
Anjel	परी
Anjesh	अन्जेश
Anjil	परी
Anjila	अन्जिला
Anjit	अन्जित
Anju	अन्जु
Anjuli	अन्जुली
Ankeet	अंकित
Ankesh	अंकेश
Ankit	अंकित
Ankita	अंकिता
Ankur	अंकुर
Ankush	अंकुश
Anmol	अनमोल
Anna	अन्ना
Annant	अनन्त
Anoj	अनोज
Anoop	अनुप
Anrood	अन्रुड
Ansan	अन्सान
Anshab	अन्शब
Anshav	अन्शव
Anshu	अंशु
Anshul	अंशुल
Anshumalee	अंशुमाली
Anshumali	अंशुमाली
Anshuman	अंशुमन
Antariksha	अन्टारिक्षा
Antisangarsha	संघर्ष विरोधी
Anu	अनु
Anubhab	अनुभ
Anubhav	अनुभव
Anubhuti	अनुभूति
Anudeep	अनुदीप
Anugya	अनुग्या
Anuj	अनुज
Anuja	अनुजा
Anujan	अनुजन
Anukram	अनुक्रम
Anukraman	अनुक्रमन
Anukul	अनुकुल
Anumuni	अनुमुनि
Anup	अनुप
Anupam	अनुपम
Anupama	अनुपमा
Anupras	अनुप्रास
Anur	अनुर
Anuraag	अनुराग
Anuradha	अनुराधा
Anurag	अनुराग
Anurodh	अनुरोध
Anurudh	अनुरुद्ध
Anurudra	अनुरुद्र
Anush	अनुस
Anusha	अनुशा
Anusharan	अनुशरण
Anusheel	अनुशील
Anushesh	अनुशेष
Anushikha	अनुशिखा
Anushil	अनुशिल
Anusuman	अनुसुमन
Anutha	अनुता
Anvesh	अन्वेश
Anwar	अन्वर
Anwesh	अन्वेश
Anweshak	अन्वेषक
Apar	अलग
Apeal	अपील
Apechhaya	अपेछाया
Apekhya	अपेख्या
Apil	एपिल
Aplesh	स्याउ
Apoorba	अपूर्व
Apoorva	अपूर्व
Appu	एप
Apsa	अप्सा
Apsana	अप्सना
Apurba	अपूर्व
Apurva	अपूर्व
Arabind	अरबिन्द
Arabinda	अरबिन्द
Arambha	आरम्भ
Arati	आरती
Arbin	अर्बिन
Arbind	अरविन्द
Arbinda	अरविन्द
Arbindra	अरविन्द्र
Archana	अर्चना
Archu	अर्चु
Ardeep	अर्दीप
Argen	अर्जेन
Aries	मेष
Arif	आरिफ
Arihant	अरिहन्त
Ariv	अरिव
Arjab	अरजब
Arjan	अर्जन
Arjesh	अर्जेश
Arjit	अरिजित
Arjun	अर्जुन
Arkeet	अर्केट
Armaan	अरमान
Arman	अरमान
Arna	अर्ना
Arnab	अर्नब
Arnav	अर्णव
Arni	अर्नी
Arnold	अर्नोल्ड
Arogya	आरोग्य
Aroj	आरोज
Aron	एरोन
Arpan	अर्पण
Arpana	अर्पण
Arpit	अर्पित
Arshad	अर्शद
Arun	अरुण
Aruna	अरुणा
Arunav	अरुणव
Arush	आरुष
Arvind	अरविन्द
Arwin	अर्विन
Arwind	अरविन्द
Arya	आर्य
Aryal	अर्याल
Aryan	आर्यन
Arzoo	आरजु
Asan	आसन
Asaraf	आसराफ
Asbin	अस्बिन
Aseem	असिम
Asesh	असेश
Aseshwar	अशेश्वर
Asha	आशा
Ashakaji	आशाकजी
Ashay	आशय
Ashbin	आशबिन
Ashchal	अस्चल
Asheem	असिम
Asheesh	आशिष
Ashes	खरानी
Ashesh	आशेस
Asheshwor	अशेश्वर
Ashfaq	अश्फाक
Ashib	आशिब
Ashik	आशिक
Ashim	आशिम
Ashin	आशिन
Ashirbad	आशिर्वाद
Ashis	आशिष
Ashish	आशिष
Ashisi	आशिसी
Ashit	आशित
Ashkal	अस्कल
Ashlesh	एश्ले
Ashma	अश्मा
Ashman	आशमान
Ashmeeta	अस्मिता
Ashmin	अश्मिन
Ashmina	अस्मिना
Ashmit	अश्मित
Ashmita	अस्मिता
Ashok	अशोक
Ashray	आश्रय
Ashrit	आश्रित
Ashu	आशु
Ashuhang	आशुहाङ
Ashuta	आशुता
Ashutosh	आशुतोष
Ashutosha	आशुतोष
Ashvin	अश्विन
Ashwin	अश्विन
Ashwini	अश्विनी
Asikh	आशिख
Asim	असिम
Asish	आशिष
Aslam	असलम
Asman	अस्मान
Asmin	अस्मिन
Asmir	अस्मिर
Asmit	अस्मित
Asmita	अस्मिता
Asmod	असमोड
Asrar	असरार
Assim	असिम
Asta	Asta
Astha	आस्था
Astik	अस्तिक
Asutosh	आसुतोष
Aswin	अश्विन
Atal	अटल
Ataur	अताउर
Ateet	अटेट
Athma	दम
Atique	पुरातन
Atish	आतिश
Atit	अतित
Atithi	अतिथी
Atlantic	एट्लान्टिक
Atma	आत्मा
Atmaram	आत्माराम
Atmesh	आत्मेश
Atul	अतुल
Atulya	अतुल्य
Audi	अडी
Auras	औरास
Avaaj	आवाज
Avanish	अवनीश
Avash	अवस
Avay	अवे
Avaya	अवया
Avhinav	अभिनव
Avhishek	अभिषेक
Avicalpa	अविकलपा
Avichandra	अविचन्द्र
Avijit	अविजित
Avikishor	अविकिशोर
Avilash	अविलश
Avilekh	अविलेख
Avimanyu	अविमन्यु
Avin	अविन
Avinab	अविनाब
Avinandan	अविनान्दन
Avinash	अविनाश
Avinav	अविनाव
Avinaya	अविना
Avineak	अविनाक
Avinesh	अविनाश
Avip	Avip
Aviral	Aviral
Avirush	अविरुष
Avisek	अविसेक
Avisekh	अविसेख
Avishek	अभिषेक
Avishekh	अविशेख
Avishesh	अविशेश
Aviskar	अविसकर
Aviwadan	अविवादन
Aviyan	एभियन
Avon	एवन
Avsar	अवसार
Awadesh	अवदेश
Awadh	अवध
Awadhesh	अवधेश
Awadhkishor	अवधकिशोर
Awakash	अवाकश
Awan	अवान
Awanish	अवनीश
Awash	आभास
Awesh	आवेश
Awishesh	आशिष
Awiskar	आविस्कर
Awornit	अशोभनीय
Ayam	अयाम
Ayan	अयान
Ayash	आयश
Ayean	अयान
Ayodhya	अयोध्या
Ayonij	अयोनिज
Ayoush	आयुष
Ayub	अयुब
Ayush	आयुष
Ayushi	आयुशी
Ayushma	आयुष्मा
Ayushman	आयुष्मान
Azaad	आजाद
Azad	आजाद
Azaj	अजाज
Azaz	अजाज
Azeem	अजीम
B	बि
Baban	बाबा
Babin	बाबिन
Babisha	बबिशा
Babita	बबिता
Bablu	बब्लु
Babu	बाबु
Babul	बाबुल
Baburam	बाबुराम
Bachan	बचन
Bachaspati	बचस्पती
Bachu	बच्चु
Badal	बादल
Badalbabu	बादलबाबु
Badan	बदन
Badhyata	बध्यता
Badri	बद्री
Bahadur	बहादुर
Baibhav	वैभव
Baidehi	बैदेही
Baidh	बैध
Baidhnath	बैधनाथ
Baidya	बैद्य
Baidyanath	वैद्यनाथ
Baijanath	बैजनाथ
Baijnath	बैजनाथ
Baiju	बैजु
Baikunth	बैकुण्ठ
Baikuntha	बैकुण्ठ
Baizu	Baizu
Bajara	बजरा
Bajarangi	बजरंगी
Bajra	बाजरा
Bajracharya	बज्राचार्य
Bajrang	बजरंग
Bajrangi	बजरंगी
Bakhat	बखत
Bal	बल
Bala	बाला
Balami	बलामी
Balaraj	बलराज
Balaram	बलराम
Baldev	बलदेव
Balendra	बालेन्द्र
Baleshwar	बालेश्वर
Balgobind	बालगोविन्द
Bali	बाली
Baliram	बलिराम
Balkrishna	बालकृष्ण
Balkumar	बालकुमार
Ballav	बल्लभ
Balman	बालमन
Balram	बलराम
Bam	बाम
Bamdev	बामदेव
Ban	प्रतिबन्ध
Bandana	बन्दना
Bandhu	बन्धु
Banish	निकाल्नुहोस्
Bankatesh	बैंकट्स
Banmali	बनमाली
Bansaj	बन्सज
Banshee	बाँशी
Banti	बन्ति
Bapin	बापिन
Baral	बराल
Bardan	बर्दान
Barkadin	बर्कादिन
Barkha	बर्खा
Barnit	बार्निट
Barsha	बर्षा
Barun	बरुण
Basant	बसन्त
Basanta	बसन्त
Basdev	बसदेव
Bashant	बसन्त
Bashanta	बसन्त
Bashu	बासु
Bashudev	बासुदेव
Bashuki	बाशुकी
Basista	बसिस्ता
Basistha	बसिष्ठा
Baski	बास्क
Basu	बसु
Basudev	बासुदेव
Basukinath	बासुकीनाथ
Basundhara	बसुन्धरा
Basutel	बसुटेल
Batsal	बत्सल
Batuk	बटुक
Baudh	बौध
Bauku	बाउकु
Bawan	बावन
Bc	Bc
Bebina	बेबिना
Bechan	बेचन
Bed	ओछ्यान
Bedan	बेदान
Bedananda	बेदानन्द
Bedraj	बेदराज
Bedram	बेडराम
Beebika	बिबिका
Beependra	बिपेन्द्र
Beezan	बेजान
Begam	बेगम
Bejil	बेजिल
Bekta	बेक्ता
Bel	बेल
Belal	बेलाल
Belove	मायालु
Beneet	बेनीत
Beni	बेनी
Benish	बेनिस
Benison	बेनिसन
Benjon	बेन्जोन
Benju	बेन्जु
Benu	बेनु
Bet	शर्त
Bhaba	भाभा
Bhabak	भाबक
Bhabesh	भवेश
Bhabin	भबिन
Bhabish	भबिस
Bhabishya	भाबिष्य
Bhabuk	भाबुक
Bhag	भाग
Bhagat	भगत
Bhagawan	भगवान
Bhagawat	भागवत
Bhagirath	भगीरथ
Bhagu	भागु
Bhagwan	भगवान
Bhagwat	भागवत
Bhagya	भाग्य
Bhai	भाइ
Bhaichung	भाइचुङ
Bhairab	भैरव
Bhairav	भैरव
Bhakta	भक्त
Bhandari	भण्डारी
Bhanu	भानु
Bhanubhakta	भानुभक्त
Bharat	भरत
Bharath	भरत
Bharati	भारती
Bhargab	भार्गब
Bhargav	भार्गव
Bhargaw	भार्गव
Bharoshi	भरोशी
Bhasan	भासन
Bhashkar	भास्कर
Bhaskar	भास्कर
Bhasker	भास्कर
Bhat	भाट
Bhatta	भट्ट
Bhattarai	भट्टराई
Bhava	भव
Bhavesh	भावेश
Bhaviendra	भविन्द्र
Bhavindra	भविन्द्र
Bhavisya	भविश्य
Bhawak	भवक
Bhawan	भवन
Bhawani	भवानी
Bhawesh	भावेश
Bheem	भीम
Bhesh	भेस
Bhesha	भेषा
Bheshraj	भेषराज
Bhibisan	भिबिसन
Bhijan	भिजन
Bhila	भिला
Bhim	भीम
Bhimarjun	भीमार्जुन
Bhimesh	भीमेश
Bhimsen	भीमसेन
Bhishma	भीष्म
Bhisma	भीष्म
Bhochhibhoya	भोछिभोया
Bhogendra	भोगेन्द्र
Bhoj	भोज
Bhojendra	भोजेन्द्र
Bhola	भोला
Bhrigu	भृगु
Bhuban	भुवन
Bhubanesh	भुवनेश
Bhubaneshwar	भुवनेश्वर
Bhugol	भुगोल
Bhujan	भुजन
Bhulok	भुलोक
Bhumi	भूमि
Bhumika	भुमिका
Bhuneshwar	भुनेश्वर
Bhup	भूप
Bhupa	भूपा
Bhupadhoj	भूपाधोज
Bhupal	भूपाल
Bhupendra	भूपेन्द्र
Bhupesh	भूपेश
Bhupin	भूपिन
Bhupnarayan	भूपनारायण
Bhupraj	भूपराज
Bhusal	भुसाल
Bhusan	भुसन
Bhushan	भूषण
Bhuvan	भुवन
Bhuvaneshwar	भुवनेश्वर
Bhuvneswer	भुवनेश्वर
Bhuwan	भुवन
Bhuwanesh	भुवनेश
Bhuwani	भुवानी
Bhuwesh	भुवेश
Bibas	बिबास
Bibash	बिबास
Bibat	बिबट
Bibechan	बिबेचन
Bibechana	बिबेचना
Bibek	बिबेक
Bibeka	बिबेका
Bibekanand	बिबेकानन्द
Bibekananda	बिबेकानन्द
Bibekman	बिबेकमान
Bibesh	बिबेश
Bibet	बिबेट
Bibhab	बाइबल
Bibham	बिभम
Bibhas	बिभास
Bibhash	बिभाष
Bibhav	बिभव
Bibhed	बाइबल
Bibhesh	बिभेस
Bibhor	बिभोर
Bibhu	बिभु
Bibhusan	बिभुषण
Bibhushan	विभूषण
Bibhuti	विभूति
Bibhutinand	विभूतिनन्द
Bibid	बिबिड
Bibidh	बिबिध
Bibin	बिबिन
Bibisha	बिबिशा
Bibush	बिबस
Bibushan	विभूषण
Bibuti	बिबुटी
Bichar	बिचार
Bickal	बिकल
Bickey	बिकी
Bickram	बिक्रम
Bicky	बिक्की
Bideha	बिदेहा
Biden	बिडेन
Bidhan	बिधान
Bidhek	बिदेक
Bidhya	विद्या
Bidhyalal	विद्यालाल
Bidhyananda	विद्यानन्द
Bidish	बिदिश
Bidit	बिडित
Bidur	बिदुर
Bidursan	बिदुरसान
Bidya	बिद्या
Bidyakant	विद्याकान्त
Bidyanand	विद्यानन्द
Biga	बिगा
Bigat	बिगोट
Bigendra	बिगेन्द्र
Biggyan	महाज्ञान
Bighnesh	बिघ्नेस
Bigya	बिग्या
Bigyan	बिगयान
Bihari	बिहारी
Bihny	बिहनी
Bihushan	बिभूषण
Biibek	बिबेक
Biijay	बिजय
Bijan	बिजन
Bijay	विजय
Bijaya	विजया
Bijayan	बिजयन
Bijayanand	विजयानन्द
Bijayash	बिजयश
Bijen	बिजेन
Bijendra	बिजेन्द्र
Bijesh	बिजेश
Bijju	बिज्जु
Biju	बिजु
Bijwol	बिजवोल
Bikal	बिकल
Bikalpa	बिकल्प
Bikas	विकास
Bikash	बिकास
Bikee	बाइक
Biken	बाइकेन
Bikendra	बिकेन्द्र
Bikesh	बिकेश
Bikey	बाइक
Bikhyat	बिख्यात
Biki	बिकी
Bikings	बाइकिङ
Bikkal	बिक्कल
Bikki	बिक्की
Bikku	बिक्कु
Bikky	बिक्की
Bikram	बिक्रम
Bikrant	बिक्रान्त
Bikranta	विक्रान्त
Bikru	बिक्रू
Biku	बिकु
Bilan	बिलान
Bilap	बिलाप
Bilash	बिलास
Bilesh	बिलेश
Bilove	बिलोभ
Biltu	बिल्टु
Bimal	बिमल
Bimala	बिमला
Bimalesh	बिमलेश
Biman	बिमान
Bimanchal	बिमाञ्चल
Bimarsha	बिमर्श
Bimash	बिमास
Bimbisar	बिम्बिसार
Bimesh	बिमेश
Bimlendra	बिमलेन्द्र
Bimlendu	बिमलेन्दु
Bimlesh	बिमलेश
Bimochan	बिमोचन
Bina	बिना
Binabh	बिनाभ
Binam	बिनाम
Binamra	बिनाम्रा
Binarma	बिनर्मा
Binay	बिनय
Binaya	बिनया
Binayak	विनायक
Bindesh	बिन्देश
Bindeshwar	बिन्देश्वर
Bindu	बिन्दु
Bindyashwori	बिन्द्येश्वरी
Bineet	बिनीत
Binendra	विनेन्द्र
Binesh	बिनेश
Binij	बिनिज
Binil	बिनिल
Binish	बिन्निश
Binisha	बिनिशा
Binit	बिनिट
Binita	बिनिता
Binod	बिनोद
Binti	बिन्ति
Bintosh	बिन्तोस
Binu	बिनु
Binup	बिनअप
Bipal	बिपाल
Bipan	बिपन
Bipana	बिपना
Bipeen	बिपेन
Bipendra	बिपेन्द्र
Bipesh	बिपेश
Bipik	बिपिक
Bipika	बिपिका
Bipin	बिपिन
Bipina	बिपिना
Bipish	बिपिश
Biplab	बिप्लब
Biplap	बिप्लप
Biplav	विप्लव
Biplaw	बिप्लव
Biplesh	बिप्लेश
Biplob	बिप्लब
Biplop	बिप्लप
Biplov	विप्लव
Biplove	बिप्लव
Bipul	बिपुल
Bipush	बिपुस
Bir	वीर
Biraj	बिराज
Birasa	बिरासा
Birat	बिराट
Biratjan	विराटजन
Birayas	बिरायस
Birbal	बीरबल
Biren	बिरेन
Birendra	वीरेन्द्र
Biresh	बिरेश
Birjendra	बिरजेन्द्र
Birkha	बिरखा
Birman	बिरमान
Biroch	बिरोच
Birochan	बिरोचन
Birodh	बिरोध
Biroj	बिरोज
Biru	बिरु
Biruj	बिरुज
Birwal	बिरवाल
Bisam	बिसम
Bisan	पनि
Bisesh	बिसेस
Bisfot	बिस्फोट
Bishab	बिशब
Bishal	बिशाल
Bishambar	बिशम्बर
Bishan	बिशन
Bishant	बिशान्त
Bisharad	बिशारद
Bishau	बिसाउ
Bishav	बिशव
Bishawamber	विश्वम्बर
Bishaz	बिशाज
Bishes	बिशेस
Bishesh	बिशेस
Bisheshwar	बिशेश्वर
Bisheshwer	विश्वेश्वर
Bishesswor	विश्वेश्वर
Bisheswor	विश्वेश्वर
Bishiwanath	बिशिवनाथ
Bishnu	विष्णु
Bishnuhari	विष्णुहरि
Bishnuraj	विष्णुराज
Bisho	बिशो
Bishodeep	बिशोदीप
Bishop	बिशप
Bishow	बिशो
Bishowram	बिशोराम
Bishram	बिश्राम
Bishrant	बिश्रान्त
Bishranta	बिश्रान्त
Bishu	बिशु
Bishuzal	बिशुजल
Bishwa	बिश्व
Bishwabandhu	विश्वबन्धु
Bishwadeep	विश्वदीप
Bishwajeet	विश्वजीत
Bishwajit	विश्वजित
Bishwakant	विश्वकान्त
Bishwalal	बिश्वलाल
Bishwambhar	विश्वम्भर
Bishwamitra	विश्वामित्र
Bishwanand	विश्वानन्द
Bishwanath	विश्वनाथ
Bishwaranjan	विश्वरञ्जन
Bishwas	बिश्वास
Bishwash	बिश्वश
Bishwesh	बिश्वेश
Bishweshwar	विश्वेश्वर
Bishwo	बिश्वो
Bishwodip	विश्वदीप
Bishwojeet	विश्वजीत
Bishworaj	विश्वराज
Bismita	बिस्मिता
Bista	बिष्ट
Biswa	बिस्वा
Biswajit	विश्वजित
Biswamber	विश्वम्बर
Biswananda	विश्वानन्द
Biswas	विश्वास
Biswash	बिश्वास
Biswo	बिस्वो
Biswok	बिस्वोक
Biswombher	बिस्वम्बर
Bittu	बिट्टु
Bivakar	बिवाकर
Bivash	बिवाश
Bivatsu	बिवात्सु
Bivek	बिवेक
Bivesh	बिवेश
Bivo	Bivo
Bivov	बिभोभ
Biwas	बिवास
Biwash	बिवाश
Biwek	Biwek
Biyan	बियान
Bk	बिके
Blessing	आशीर्वाद
Bobby	बबी
Bobin	बबिन
Bodh	बोध
Bodha	बुद्ध
Bodhendra	बोधेन्द्र
Bohara	बोहरा
Bolbam	बोलबम
Bom	बम
Bonash	बोनास
Bonish	बोनिस
Bonot	बोनोट
Bp	Bp
Brabim	ब्राबिम
Brabina	ब्राबिना
Brahamdev	ब्रह्मदेव
Brahma	ब्रह्मा
Brahmanand	ब्रह्मानन्द
Braj	ब्रज
Brajendra	ब्रजेन्द्र
Brajesh	ब्रजेश
Briendra	ब्रिेन्द्र
Brihat	बृहत
Brij	पुल
Brijesh	बृजेश
Brijkishor	ब्रिजकिशोर
Briju	बृजु
Brikhesh	बृखेश
Brikodar	बिकोदर
Brishan	ब्रिशन
Brishav	वृषभ
Britam	बेलायत
Britant	बेलायती
Bruce	ब्रुस
Buddha	बुद्ध
Buddhi	बुद्ध
Buddhiman	बुद्धमान
Buddhinath	बुद्धनाथ
Buddhiraj	बुद्धराज
Buddi	साथी
Budh	बुद्ध
Budhathoki	बुढाथोकी
Budhdha	बुद्ध
Budhi	बुढी
Budhiram	बुढीराम
Bullit	गोली
Bunilal	बुनिलाल
Byanjankar	ब्याञ्जनकार
Byapak	ब्यापाक
Byas	ब्यास
Caesar	सिजर
Calvin	क्याल्भिन
Caudhary	चौधरी
Cecial	सेसिल
Cesar	सिजर
Chabilal	छबिलाल
Chait	चैत
Chaitanya	चैतन्य
Chaitya	चैत्य
Chakka	चक्का
Chakra	चक्र
Chakrabarti	चक्रवर्ती
Chakrajeet	चक्रजित
Chakrapani	चक्रपानी
Chan	चान
Chanchal	चंचल
Chand	चन्द
Chanda	चन्द
Chandan	चन्दन
Chandananda	चन्दनन्द
Chandani	चाँदनी
Chandara	चन्द्र
Chandesh	चण्डेश
Chandeshwar	चण्डेश्वर
Chandeshwor	चण्डेश्वर
Chandik	चण्डिक
Chandika	चण्डिका
Chandnandan	चन्दनन्दन
Chandra	चन्द्र
Chandrabhawan	चन्द्रभवन
Chandrakant	चन्द्रकान्त
Chandramani	चन्द्रमणि
Chandrashekhar	चन्द्रशेखर
Chandreshwar	चन्द्रेश्वर
Chandrika	चन्द्रिका
Charchil	चर्चिल
Charchit	चारचित
Chardham	चारधाम
Chatur	चतुर
Chaturanand	चतुरानन्द
Chaturbhuj	चतुर्भुज
Chaudhary	चौधरी
Chaudhary-roshan	चौधरी-रोशन
Chaulagain	चौलागाईं
Chaularaj	चौलाराज
Chayan	च्यान
Cherub	करूब
Chesta	छाती
Chet	चेट
Chetan	चेतन
Chetnath	चेतनाथ
Chetraj	चेतराज
Chewan	चेवान
Chhabi	छबी
Chhabilal	छबिलाल
Chhabindra	छबिन्द्र
Chhabiraj	छविराज
Chhakka	छक्का
Chhanda	छन्द
Chhatish	छत्तीस
Chhatra	छत्र
Chhetra	क्षेत्र
Chhetri	क्षेत्री
Chhewang	छेवाङ
Chhiring	छिरिङ
Chhitiz	चिटिज
Chhote	छोटे
Chhotelal	छोटेलाल
Chhotu	छोटु
Chij	चिज
Chinmay	चिन्मय
Chinta	चिन्ता
Chintaharan	चिन्ताहरण
Chintamani	चिन्तामणि
Chintan	चिन्तन
Chiraag	चिराग
Chirag	चिराग
Chiran	चिरन
Chiranjaibi	चिरञ्जबी
Chiranjeebi	चिरञ्जीबे
Chiranjeevee	चिरञ्जीवी
Chiranjhivi	चिरञ्जीवी
Chiranjibee	चिरञ्जीबी
Chiranjibi	चिरञ्जीवी
Chiranjivi	चिरञ्जीवी
Chirantan	चिरन्तन
Chirasmriti	चिरस्मृति
Chirayu	चिरायु
Chirnjeewee	चिरञ्जीवी
Chitij	चिटिज
Chitra	चित्रा
Chitrakar	चित्रकार
Chitraketu	चित्रकेतु
Chitramani	चित्रमणि
Chitran	चित्रण
Chitranand	चित्रानन्द
Chitranjan	चितरञ्जन
Chitranshu	चित्रांशु
Chok	चोक
Cholakanta	चोलकान्त
Chongba	चोङ्बा
Choodamani	चौडामणि
Choudhary	चौधरी
Christopher	क्रिस्टोफर
Chuda	चुडा
Chudamadi	चुडामडी
Chudamandi	चुडामण्डी
Chudamani	चुडामणि
Chumakanta	चुमाकान्त
Chuman	चुमान
Chumlung	चुम्लुङ
Chunchun	चुन्चुन
Chunnu	चुन्नु
Churamani	चुरामनी
Chutra	चुत्रा
Chutuna	चुटुना
Clain	क्लेन
Clinton	क्लिन्टन
Curious	जिज्ञासु
Cyamiron	साइमिरोन
Cynthia	सिन्थिया
Cyrus	साइरस
Cyrush	साइरस
Dabbal	डब्बल
Dabit	Dabit
Dahal	दाहाल
Dainik	दैनिक
Dak	डाक
Dakshina	दक्षिणा
Dal	दाल
Dalim	दलिम
Daman	दामन
Dambar	डम्बर
Damber	डम्बर
Damma	धम्म
Dammar	डम्मर
Damodar	दामोदर
Dan	डेन
Danda	डन्डा
Dandi	डन्डी
Daneshwar	दानेश्वर
Dangol	डंगोल
Daniel	डेनियल
Danish	डेनिस
Darkaji	डार्कजी
Daroga	दरोगा
Darpan	दर्पण
Darshan	दर्शन
Darwin	डार्विन
Das	दास
Dasharatha	दशरथ
Dashram	दशराम
Dashrath	दशरथ
Dave	डेभ
David	डेभिड
Dawa	दावा
Dawadi	दवाडी
Daya	दया
Dayanand	दयानन्द
Dayaram	दयाराम
Dayasagar	दयासागर
Dayitwa	डेइटवा
Deb	देब
Debanjan	देबन्जन
Debendra	देबेन्द्र
Debesh	देबेश
Debi	देबी
Debid	डेबिट
Debin	डेबिन
Debish	देविस
Debit	डेबिट
Deebash	दिवाश
Deechyant	Deechyant
Deej	डीज
Deekshanta	दीक्षाान्त
Deelip	दिलिप
Deenbandhu	दीनबन्धु
Deep	गहिरो
Deepa	दिपा
Deepak	दिपक
Deepal	दिपल
Deepandra	दीपेन्द्र
Deepankar	दिपङ्कर
Deepen	गहिरो
Deependra	दिपेन्द्र
Deepesh	दिपेश
Deepika	दिपिका
Deepin	दीपिन
Deepjoti	दिपजोति
Deeplove	Deeplove
Deeptanshu	दीपांशु
Deepti	दिप्ति
Deepu	दिपु
Deevakar	देवकर
Deewakar	दिवाकर
Deewash	दिवाश
Deewendra	दिवेन्द्र
Dekh	देख
Delon	डेलोन
Dendi	डेन्डी
Dendy	डन्डी
Denish	डेनिस
Denjam	डेन्जाम
Dennis	डेनिस
Denny	डेनी
Deo	देव
Depak	देपाक
Depash	प्रेषण
Depen	डिपेन
Dependra	दिपेन्द्र
Depenti	निर्भर
Depesh	दिपेश
Desh	ड्यास
Deshbhakta	देशभक्त
Deshmuka	देशमुख
Deshraj	दशराज
Deu	देउ
Deukaji	देउकाजी
Deuman	देउमन
Dev	देव
Deva	देवा
Devanand	देवानन्द
Devananda	देवानन्द
Devaraj	देवराज
Devashish	देवाशिष
Devbrat	देवब्रत
Devbratta	देवब्रत
Devendra	देवेन्द्र
Devesh	देवेश
Devi	देवी
Devina	देविना
Devindra	देवेन्द्र
Devkant	देवकान्त
Devnandan	देवनन्दन
Devnath	देवनाथ
Devottam	देवोत्तम
Devpujan	देवपूजन
Devraj	देवराज
Dewakar	देवाकर
Dewaki	देवकी
Dewan	दिवान
Dewanand	देवानन्द
Dewangsh	देवाङ्स
Dewash	देवास
Dewashish	देवाशिष
Dewesh	देवेश
Dfasd	Dfasd
Dhak	ढाका
Dhaka	ढाका
Dhakal	ढकाल
Dhakendra	ढकेन्द्र
Dhan	धन
Dhana	धना
Dhananjay	धनन्जय
Dhananjaya	धनन्जय
Dhanapati	धनपति
Dhanbir	धनवीर
Dhaneshwar	धनेश्वर
Dhaneshwor	धनेश्वर
Dhanik	धानिक
Dhanjit	धनजित
Dhanlal	धनलाल
Dhanpati	धनपति
Dhanraj	धनराज
Dhanu	धनु
Dhanush	धनुष
Dharamendra	धर्मेन्द्र
Dharamnath	धरमनाथ
Dharbendra	धरबेन्द्र
Dharm	धर्म
Dharma	धर्म
Dharmagat	धर्मगत
Dharmanath	धर्मनाथ
Dharmendra	धर्मेन्द्र
Dharmod	धर्मोद
Dharnidhar	धरनिधर
Dharti	धरती
Dharwendra	धर्वेन्द्र
Dhawa	धवा
Dhawak	धवक
Dheer	धीर
Dheeraj	धीरज
Dhipendra	धिपेन्द्र
Dhir	धिर
Dhiraj	धिरज
Dhiran	धिरान
Dhiranjan	धिरञ्जन
Dhiren	धीरेन
Dhirenddra	धीरेन्द्र
Dhirendra	धीरेन्द्र
Dhiri	धिरी
Dhiroj	धिरोज
Dhital	धिताल
Dhrub	ध्रुब
Dhruba	ध्रुव
Dhrubananda	ध्रुवानन्द
Dhrubb	ध्रुब
Dhruva	ध्रुव
Dhruwa	ध्रुव
Dhundi	धुन्डी
Dhundup	धुन्डुप
Dhupendra	धुपेन्द्र
Dhurba	धुर्वा
Dhurva	धुर्वा
Dibakar	दिवाकर
Dibas	दिवास
Dibash	दिबश
Dibbesh	दिब्बेश
Dibek	दिबेक
Dibesh	दिवेश
Dibin	डिबिन
Dibya	दिव्या
Dibyadhar	दिव्याधर
Dibyank	दिव्यांक
Dibyesh	दिव्येश
Dichant	Dichant
Dichhyant	दिचिन्त
Diforce	डिफोर्स
Dig	खन्नुहोस्
Digambar	दिगम्बर
Digamber	दिगम्बर
Digbijay	दिग्विजय
Digbijaya	दिग्विजय
Digdarsan	दिग्दर्शन
Digdarshan	दिग्दर्शन
Diggaj	दिग्गज
Digo	डिगो
Digvijay	दिग्विजय
Digvijaya	दिग्विजय
Dij	डिज
Dijen	डिजेन
Dikendra	दिकेन्द्र
Dikesh	दिकेश
Dikpal	दिक्पाल
Diksan	डिक्सन
Diksha	दिक्षा
Dikshan	दिक्षा
Dikshant	दिक्षान्त
Dikshit	दीक्षित
Dikshya	दिक्षा
Dikshyant	दिक्ष्यन्त
Dil	दिल
Dila	डिला
Dilaram	डिलाराम
Dildar	दिलदार
Dileep	दिलिप
Dilendra	दिलीन्द्र
Dilesh	दिलीस
Dilip	दिलीप
Dilli	दिल्ली
Dilliram	डिल्लीराम
Dilly	डिली
Dilman	दिलमान
Dilmohammad	दिलमोहम्मद
Dilraj	दिलराज
Dilshad	दिलशाद
Diman	दिमन
Dimpal	डिम्पल
Dimson	डिम्सन
Dimup	डिमप
Din	दिन
Dina	दिना
Dinakar	दिनाकर
Dinanath	दीनानाथ
Dinank	दिनाङ्क
Dinendra	दिनेन्द्र
Dinesh	दिनेश
Dineshwar	दिनेश्वर
Dineshwor	दिनेश्वर
Dinjul	दिनजुल
Dinkar	दिनकर
Dinker	डिंकर
Dip	डुबाउनुहोस्
Dipa	दिपा
Dipak	दिपक
Dipal	दिपल
Dipan	दिपन
Dipankar	दिपङ्कर
Dipanker	दिपङ्कर
Dipek	दिपेक
Dipen	दिपेन
Dipendar	निर्भर
Dipendra	दिपेन्द्र
Dipesh	दिपेश
Dipeshwar	दिपेश्वर
Dipeshwor	दिपेश्वर
Dipgest	Dipgest
Dipika	दिपिका
Dipin	दिपिन
Dipinti	दिपिन्ति
Dipisha	दिपिशा
Dipkamal	दिपकमल
Dipkiran	दिपकिरण
Diponkar	दिपोन्कर
Dipraj	दिपराज
Dipson	डिप्सन
Dipu	दिपु
Diraj	दिराज
Dirban	डरबन
Dirga	दिर्गा
Dirgha	दिर्घा
Dirghayu	दिर्घायु
Dirishya	दिरिस्या
Dishant	दिशान्त
Dishit	दिशीत
Dishoj	दिशोज
Dishyanta	दिशान्ता
Dison	डिसन
Ditish	दितिश
Divakar	दिवाकर
Divas	दिवस
Divash	दिवाश
Divesh	दिवेश
Divijan	दिविजन
Divya	दिव्या
Divyamani	दिव्यामणि
Divyanshu	दिव्यांशु
Diwakar	दिवाकर
Diwaker	दिवाकर
Diwan	दिवान
Diwas	दिवास
Diwash	दिवा
Diwat	दिवत
Diwesh	दिवेश
Diwos	दिवोस
Dixit	दीक्षित
Diya	दीया
Dllip	Dllip
Dn	Dn
Dol	डोल
Dolendra	डोलेन्द्र
Dolma	डोल्मा
Dolraj	डोलराज
Dondup	डन्डअप
Dongol	डोङ्गोल
Donipolo	डोनिपोलो
Dor	डोर
Dorak	दोराक
Dorje	दोर्जे
Dorkaji	दोरकाजी
Dorna	डोर्ना
Dr	डा
Drana	द्रणा
Drawendra	ड्रेन्द्र
Drbhagwan	द्रभगवान
Drish	ड्रिस
Drishya	दृष्टि
Dristant	Dristan
Dristi	चिसो
Drjiba	Drjiba
Dron	ड्रोन
Drona	द्रोण
Dronachandra	द्रोणचन्द्र
Drrajendra	राजेन्द्र डा
Drupad	द्रुपद
Dudhraj	दुधराज
Dugra	दुगरा
Dujendra	दुजेन्द्र
Dukhan	दुखान
Dukhi	दुखी
Dukka	डुक्का
Duman	डुमन
Dumeshwor	डुमेश्वर
Durand	डुरान्ड
Durga	दुर्गा
Durgendra	दुर्गेन्द्र
Durgesh	दुर्गेश
Durlabh	दुर्लभ
Durlav	दुर्लभ
Durugendra	दुर्गेन्द्र
Duryodhan	दुर्योधन
Dushan	दुशन
Dushyant	दुष्यन्त
Dushyanta	दुष्यन्त
Dutta-sanjib	दत्त-संजिब
Duwarika	दुवारिका
Dwaipayan	द्वैपायन
Dware	Dware
Dwarika	द्वारिका
Eak	इक
Ebin	एबिन
Edward	एडवर्ड
Egesh	एगेश
Ehsan	एहसान
Ejan	इजान
Ejesh	जेस
Ejin	इजिन
Ek	एक
Eka	इका
Ekaraj	एकराज
Ekata	एकता
Ekendra	एकेन्द्र
Ekhlak	एखलाक
Ekisha	एकिशा
Eklal	एकलाल
Ekraj	एकराज
Ekta	एकता
Eleena	एलेना
Elij	एलिज
Elijan	एलिजान
Elina	एलेना
Elish	एलिस
Elisha	एलीशा
Eliz	एलिज
Eliza	एलिजा
Elizaveta	एलिजाभेटा
Elliott	इलियट
Elvis	एल्विस
Elzin	एल्जिन
Emil	एमिल
Endi	Endi
Enish	एनिस
Enoj	हनोक
Enosh	एनोस
Enup	Enup
Eric	एरिक
Erik	एरिक
Erina	इरिना
Eriz	एरिज
Erojan	इरोजन
Eshap	भाग्नुहोस्
Eshwar	ईश्वर
Europ	युरोप
Europe	युरोप
Evan	इभान
Fabin	फेबिन
Faiyaz	फैयाज
Faizan	फैजान
Fam	परिवार
Fanikanta	फणीकान्त
Fanindra	फनिन्द्र
Farendra	फरेन्द्र
Farhan	फरहान
Farindra	फरिन्द्र
Farooque	फारुक
Feeroj	फिरोज
Firaj	फिराज
Firoj	फिरोज
Firoz	फिरोज
Francis	फ्रान्सिस
Francish	फ्रान्सिस
Franco	फ्रान्को
Frank	फ्रान्क
Ful	फुल
Fungma	फङ्मा
Furba	फुर्बा
Gagal	गागल
Gagan	गगन
Gahendra	गहेन्द्र
Gaire	गैरी
Gajadhar	गजाधर
Gajen	गजेन
Gajendr	गजेन्द्र
Gajendra	गजेन्द्र
Gajendraman	गजेन्द्रमान
Galab	गलाब
Gambheer	गम्भीर
Gambhir	गम्भीर
Gambihar	गम्भर
Gandhi	गान्धी
Gandira	गान्डिरा
Ganesh	गणेश
Ganga	गंगा
Gangadhar	गंगाधर
Gangalal	गङ्गालाल
Gangasagar	गंगासागर
Gangesh	गङ्गेश
Ganja	गांजा
Garima	गरिमा
Gaulochan	गौलोचन
Gaurab	गौरव
Gaurabh	गौरव
Gaurav	गौरव
Gauree	गौरी
Gauri	गौरी
Gaurilal	गौरीलाल
Gautam	गौतम
Gaya	गया
Gayan	गायन
Gayandra	गायन्द्रा
Gc	Gc
Geetanjali	गीताञ्जली
Gehendra	गेहेन्द्र
Gena	जेना
Ghamand	घमाण्ड
Ghamashan	घमासान
Ghan	घान
Ghana	घाना
Ghananand	घनानन्द
Ghanashyam	घनश्याम
Ghanendra	घनेन्द्र
Ghaneshyam	घनश्याम
Ghanshyam	घनश्याम
Ghanu	घनु
Ghimire	घिमिरे
Ghisiawan	घिसियावान
Gibson	गिब्सन
Gineez	Gineez
Gir	गिर
Girdhari	गिरधारी
Girendra	गिरेन्द्र
Giresh	गिरेश
Giri	गिरी
Giridhar	गिरिधर
Girija	गिरिजा
Girijesh	गिरिजेश
Giriraj	गिरिराज
Girish	गिरीश
Girwan	गिरवान
Gitam	गीतम
Gitesh	गितेश
Gobardhan	गोवर्धन
Gobind	गोविन्द
Gobinda	गोविन्द
Gogan	गोगन
Gokarn	गोकर्ण
Gokarna	गोकर्ण
Gokrna	गोकर्ण
Gokul	गोकुल
Gokulanand	गोकुलानन्द
Golden	सुनौलो
Gopal	गोपाल
Gopesh	गोपेश
Gopeswar	गोपेश्वर
Gopi	गोपी
Gopichand	गोपीचन्द
Gopinath	गोपीनाथ
Gopiram	गोपीराम
Gorakh	गोरख
Gorakha	गोरखा
Gorash	गोरश
Gore	गोरे
Gorkhanath	गोरखानाथ
Goswami	गोस्वामी
Gotani	गोटानी
Govind	गोविन्द
Govinda	गोविन्द
Greejesh	ग्रीजेश
Grish	ग्रिस
Grishm	ग्रिष्म
Grishma	ग्रिष्मा
Grivab	ग्रिवब
Gudan	गुडान
Guddu	गुड्डु
Gudiya	गुडिया
Gudoo	गुडु
Gudu	गुडु
Guinness	गिनिज
Gulshan	गुलशन
Gun	बन्दुक
Guna	गुना
Gunakar	गुणाकर
Gunanand	गुणानन्द
Gunananda	गुणानन्द
Gunaraj	गुणराज
Guneshwar	गुणेश्वर
Gunja	गुन्जा
Gunjaman	गुञ्जमान
Gunjan	गुञ्जन
Gunjay	गुञ्जय
Gunjesh	गुञ्जेश
Gunraj	गुनराज
Gupta	गुप्ता
Guragain	गुरागाईं
Guru	गुरु
Gurudev	गुरुदेव
Gurung	गुरुङ
Gyabihang	ग्याविहाङ
Gyaljin	ग्याल्जिन
Gyan	ज्ञान
Gyandeep	ज्ञानदीप
Gyandendra	ज्ञानेन्द्र
Gyandip	ज्ञानदीप
Gyanendra	ज्ञानेन्द्र
Gyanesh	ज्ञानेश
Gyaneshwor	ज्ञानेश्वर
Gyaneswar	ज्ञानेश्वर
Gyani	ज्ञानी
Gyanij	ज्ञानीज
Gyansagar	ज्ञानसागर
Gyanu	ज्ञानु
Gyapan	ग्यापन
Gyawali	ज्ञवाली
H	एच
Habin	हबिन
Habish	हबिस
Hadew	Hadew
Hamal	हमाल
Hans	हान्स
Hansal	हंसल
Hansha	हान्सा
Hanuman	हनुमान
Hanumant	हनुमन्त
Happy	खुसी
Hara	हारा
Harak	हरक
Hardik	हार्दिक
Hare	खरायो
Harendra	हरेन्द्र
Hareram	हरेराम
Haresh	हरेश
Hari	ह्यारी
Haribansh	हरिवंश
Haribol	हरिबोल
Harichandra	हरिचन्द्र
Haricharan	हरिचरण
Haridev	हरिदेव
Harihar	हरिहर
Harikrishna	हरिकृष्ण
Harindra	हरिन्द्र
Hariom	हरिओम
Hariram	हरिराम
Harisaran	हरिसरण
Harischandra	हरिश्चन्द्र
Harish	हरिस
Harisharan	हरिशरण
Harivansha	हरिवंश
Harjit	हरजित
Hark	हर्क
Harka	हर्क
Harsha	हर्ष
Harshikesh	हर्षिकेश
Harsimran	हरसिमरन
Hasana	हसना
Hasin	हसिन
Hasina	हसिना
Hasrat	हसरत
Hasta	हस्त
Heena	हिना
Hegendra	हेगेन्द्र
Hel	नरक
Helan	हेलेन
Hem	हेम
Hema	हेमा
Heman	उहाँले मानिस
Hemanchal	हेमाञ्चल
Hemant	हेमन्त
Hemanta	हेमन्त
Hemanto	हेमन्त
Hemchandra	हेमचन्द्र
Hemendra	हेमेन्द्र
Hemkant	हेमकान्त
Hemlal	हेमलाल
Hemraj	हेमराज
Henangsu	हेनाङसु
Henish	हेनिस
Hera	हेरा
Heramb	हेरम्ब
Hereram	हेरराम
Heriz	हेरिज
Heron	बगुला
Hexon	हेक्सन
Hikmat	हिकमत
Hilson	हिल्सन
Him	उहाँलाई
Hima	हिमा
Himal	हिमाल
Himalaya	हिमालय
Himali	हिमाली
Himalprakash	हिमालप्रकाश
Himanshu	हिमांशु
Himansu	हिमांसु
Himesh	हिमेश
Himmat	हिम्मत
Himshail	हिमशैल
Hina	हिना
Hinsh	हिन्स
Hira	हिरा
Hiramani	हिरामणी
Hiranya	हिरण्य
Hirendra	हिरेन्द्र
Hiron	हिरोन
Hit	हिट
Hitendra	हितेन्द्र
Hitesh	हितेश
Hom	घर
Homanath	होमनाथ
Homendra	होमेन्द्र
Homesh	होमेश
Homnath	होमनाथ
Hona	होन्ना
Hrainya	हर्निया
Hriday	हृदय
Hridaya	हृदय
Hridesh	ह्रदेश
Hridyesh	ह्रदेश
Hrikesh	ऋकेश
Hrishabh	ऋषभ
Hrishav	ऋषव
Hrisheekesh	ऋषिकेश
Hrishikesh	ऋषिकेश
Hrishit	ऋषित
Hrishiv	ऋषिव
Hriteek	ऋतिक
Hrithik	ऋतिक
Hritik	ऋतिक
Hriyesh	हरीश
Hum	हुम
Huma	हुमा
Humacanta	Humacanta
Humakanta	हुमाकान्त
Hupen	हुपेन
Husen	हुसेन
Hutraj	हुत्रज
Hutta	हुट्टा
Ibin	इबिन
Ichchha	इच्छा
Ichha	इच्छा
Iha	इहा
Ijan	इजान
Ijhar	इजर
Ikesh	इकेश
Ilashree	इलाश्री
Image	छवि
Iman	इमान
Imdad	इमदाद
Imjal	इम्जाल
Imran	इमरान
Imtiyaz	इम्तियाज
In	मा
Inam	इनाम
Indalesh	इन्दलेश
Indibar	इन्दिबार
Indra	इन्द्र
Indrahang	इन्द्रहाङ
Indrajit	इन्द्रजित
Indresh	इन्द्रेश
Indu	इन्ड
Inesh	इनेश
Ingroj	इन्ग्रोज
Injmamul	इन्जमामुल
Inoj	इनोज
Inshan	इन्सान
Inshiya	इन्सिया
Irad	इराड
Iraj	इराज
Irajan	इरान
Irfan	इरफान
Iroj	इरोज
Irshad	इरशाद
Isha	ईशा
Ishab	इशाब
Ishad	इशाद
Ishan	इशान
Ishat	इशत
Ishawari	ईश्वरी
Ishor	ईशोर
Ishu	इशु
Ishwar	ईश्वर
Ishwari	ईश्वरी
Ishwary	ईश्वरी
Ishwer	ईश्वर
Ishwor	ईश्वर
Ishwori	ईश्वरी
Ismam	इस्माम
Isman	इसमान
Israr	इजरायल
Istiyaq	इस्तियाक
Iswar	ईश्वर
Iswari	ईश्वरी
Iswor	ईश्वर
Iwan	इभान
Jaanam	जानम
Jabeen	जबीन
Jag	जग
Jagadamba	जगदम्बा
Jagadeep	जगदीप
Jagadish	जगदीश
Jagadishwar	जगदीश्वर
Jagadishwor	जगदीश्वर
Jagadiswar	जगदीश्वर
Jagan	जगन
Jagannath	जगन्नाथ
Jagar	जागर
Jagarnath	जगरनाथ
Jagat	जगत
Jagati	जगती
Jagdish	जगदीश
Jagdishwor	जगदीश्वर
Jageshwar	जागेश्वर
Jageshwor	जागेश्वर
Jageswor	जगेश्वर
Jagidish	जगदीश
Jagram	जगग्राम
Jagrit	जागृत
Jaguram	जगुराम
Jah	जाह
Jahendra	जहेन्द्र
Jahid	जाहिद
Jahir	जाहिर
Jai	जय
Jaiky	जयकी
Jain	जैन
Jainath	जैनाथ
Jaindra	जैन्द्र
Jairaj	जयराज
Jaishi	जयशी
Jaisi	जैसी
Jaisu	जैसु
Jakir	जाकिर
Jalad	जलद
Jalauddin	जलाउद्दीन
Jalendra	जलेन्द्र
Jalesh	जलेश
Jalin	जालिन
James	जेम्स
Jamil	जमील
Jamin	जमिन
Jamir	जमीर
Jamuna	जमुना
Janadesh	जनदेश
Janak	जनक
Janaki	जानकी
Janam	जनम
Janap	जनप
Janardan	जनार्दन
Janardhan	जनार्दन
Janarjan	जनार्जन
Janashrit	जनश्री
Jandeep	जनदीप
Janesh	जनेश
Jang	जङ्ग
Janga	जङ्गा
Jangam	जङ्गम
Jangbahadur	जंगबहादुर
Janjit	जनजित
Janmejaya	जनमेजया
Janup	जनअप
Jashis	जसिस
Jashodhanand	जशोधानन्द
Jashpal	जसपाल
Jaskaran	जसकरण
Jasman	जसमान
Jatadhar	जटाधर
Jatil	जतिल
Jatin	जतिन
Javed	जावेद
Jawahar	जवाहर
Jawed	जावेद
Jay	जय
Jaya	जय
Jayaj	जयज
Jayakar	जयकार
Jayan	जयन
Jayanand	जयानन्द
Jayananda	जयनन्द
Jayandra	जयन्द्र
Jayant	जयन्त
Jayanta	जयन्ता
Jayanti	जयन्ती
Jayantia	जयन्त्या
Jayaram	जयराम
Jayash	जयस
Jayaswal	जयस्वाल
Jayata	जयता
Jaybabu	जयबाबु
Jaydeep	जयदीप
Jayendra	जयेन्द्र
Jayesh	जयेश
Jaykant	जयकान्त
Jaykaran	जयकरण
Jaynandan	जयनन्दन
Jaynath	जयनाथ
Jayram	जयराम
Jayson	जेसन
Jebin	जेबिन
Jeeb	जिब
Jeebachh	जिबछ
Jeeban	जीवन
Jeebanand	जीवनानन्द
Jeebesh	जिबेश
Jeebeswor	जीवनेश्वर
Jeeevan	जीवन
Jeena	जीना
Jeet	जित
Jeetendra	जितेन्द्र
Jeeva	जिवा
Jeevachh	जिवछ
Jeevan	जीवन
Jeevesh	जिव्स
Jeewan	जीवन
Jeewanand	जीवनानन्द
Jeewasmi	जीवास्मि
Jehen	जेहेन
Jems	जेम्स
Jen	जेन
Jenash	जेनास
Jendi	जेन्डी
Jeneshree	जेनेश्री
Jenish	जेनिस
Jenisha	जेनिशा
Jenius	जीनियस
Jenson	जेन्सन
Jes	जेस
Jeshan	जेशन
Jetendra	जितेन्द्र
Jha	झा
Jhabindra	जबिन्द्र
Jhak	झक
Jhalak	झलक
Jhanak	झनक
Jhapat	झापाट
Jhapendra	झापेन्द्र
Jhapper	झापर
Jharana	झरना
Jharendra	जरेन्द्र
Jhimi	झिमी
Jhonson	जोन्सन
Jiba	जिबा
Jibachh	जिबछ
Jibakant	जिबकान्त
Jiban	जीवन
Jibash	जिबस
Jibendra	जिबेन्द्र
Jibraj	जिबराज
Jidesh	जिदेश
Jigyas	जिग्यास
Jigyasha	जिज्ञासा
Jigyashu	जिग्यासु
Jilani	जिलानी
Jinendra	जिनेन्द्र
Jinesh	जिनेश
Jisan	जिसान
Jishan	जिशन
Jishnu	जिष्णु
Jit	जित
Jita	जिता
Jiten	जितेन
Jitendra	जितेन्द्र
Jitesh	जितेश
Jiva	जिव
Jivan	जीवन
Jivendra	जिवेन्द्र
Jivesh	जीवेश
Jiwan	जीवन
Jnanendra	ज्ञानेन्द्र
Jog	जोग
Jogendra	जोगेन्द्र
Jogesh	जोगेश
Jognarayan	जोगनारायण
John	जोन
Johnson	जोन्सन
Johny	जोनी
Jokhu	जोखु
Jonas	जोनास
Jonathan	जोनाथन
Jonesh	जोन्स
Jonish	जोनिस
Jonsan	जोन्सन
Jor	जोर
Joram	जोराम
Jordan	जोर्डन
Joseph	जोसेफ
Joshan	जोसन
Joshi	जोशी
Joy	आनन्द
Joyti	जोति
Jubair	जुबैर
Juben	जुबेन
Jug	जग
Jugal	जुगल
Jugesh	जुगेश
Juju	जुजु
June	जुन
Juned	जुन
Junil	जुनिल
Junu	जुन
Jupiter	बृहस्पति
Justin	जस्टिन
Jwala	ज्वाला
Jyashmine	ज्याश्मीन
Jyoti	ज्योति
Jyotindra	ज्योतिन्द्र
Jyotish	ज्योतिष
Jyotshana	ज्योत्सना
Jyotsna	ज्योत्स्ना
Kabi	काबी
Kabil	काबिल
Kabim	कबिम
Kabin	केबिन
Kabina	केबिन
Kabindra	कविन्द्र
Kabir	कबीर
Kabiraj	कविराज
Kabish	कबिस
Kabita	कविता
Kafle	काफ्ले
Kagi	कागी
Kai	काई
Kailash	कैलाश
Kailashkaji	कैलाशकाजी
Kaishar	कैसर
Kajal	काजल
Kaji	काजी
Kajol	काजोल
Kaju	काजू
Kal	Cal
Kalash	कलश
Kalayan	कल्याण
Kalendra	पात्रो
Kali	काली
Kalidas	कालिदास
Kalidash	कालिदास
Kaliraj	कलिराज
Kalpalata	कल्पलता
Kalpana	कल्पना
Kalpesh	कल्पेश
Kalpit	कल्पित
Kalu	कालु
Kalyan	कल्याण
Kamal	कमल
Kamala	कमला
Kamalendra	कमलेन्द्र
Kamalesh	कमलेश
Kamana	कामना
Kamar	कमर
Kameshwar	कामेश्वर
Kamlesh	कमलेश
Kamleshwar	कमलेश्वर
Kanaiya	कनैया
Kanak	कनक
Kanchan	कञ्चन
Kanchha	कान्छा
Kandal	कण्डल
Kandel	कँडेल
Kanhaiya	कन्हैया
Kanishk	कनिष्क
Kanta	कान्ता
Kanth	कान्थ
Kantish	कान्तिश
Kaphle	काफ्ले
Kapil	कपिल
Kapildev	कपिल देव
Kapindra	कपिन्द्र
Kapka	काप्का
Kapun	कपुन
Kapur	कपुर
Karan	करण
Karishma	करिश्मा
Karki	कार्की
Karm	कर्म
Karma	कर्म
Karna	कर्ण
Kartikesh	कार्तिकेश
Karun	करुण
Karuna	करुणा
Karunakar	करुणाकर
Kasaju	कसजु
Kasam	कसम
Kashendra	कशेन्द्र
Kashi	काशी
Kashinath	काशीनाथ
Kashindra	कशिन्द्र
Kashish	कशिश
Kashyap	कश्यप
Kasindra	कासिन्द्र
Kasip	कासिप
Katwalbonash	कटवालबोनाश
Kaurab	कौरब
Kaushal	कौशल
Kaushalendra	कौशलेन्द्र
Kaushik	कौशिक
Kaushlendra	कौशलेन्द्र
Kaushtup	कौस्तुप
Kaustubh	कौस्तुभ
Kavi	कवि
Kavikant	कविकान्त
Kavindra	कविन्द्र
Kaviraj	कविराज
Kavita	कविता
Kawach	कवाच
Kawan	कवन
Kayastha	कायस्थ
Kayub	कयुब
Kc	केसी
Kcnir	Kcnir
Kebal	केबल
Kebin	केबिन
Kedar	केदार
Kedarnath	केदारनाथ
Kedil	केडिल
Kehar	केहर
Keith	किथ
Kelin	केलिन
Kendra	केन्द्र
Kenu	केनु
Keron	केरोन
Kesab	केसब
Kesav	केशव
Kesh	केश
Keshab	केशव
Keshant	केशान्त
Keshar	केशर
Keshari	केशरी
Kesharman	केशरमान
Keshav	केशव
Keshaw	केशव
Keshwaswarananda	केशस्वरानन्द
Kevin	केभिन
Kewal	केवल
Keyur	केयुर
Khadak	खडक
Khadananda	खादानन्द
Khadendra	खदेन्द्र
Khadga	खड्ग
Khadk	खडक
Khadka	खड्का
Khaga	खगा
Khagaraj	खगराज
Khagendra	खगेन्द्र
Khages	खगेस
Khagesh	खगेश
Khageshwar	खगेश्वर
Khakendra	खकेन्द्र
Khaleeq	खालिक
Khalid	खालिद
Khamma	खम्मा
Khanal	खनाल
Khanda	खान्डा
Khangendra	खंगेन्द्र
Kharel	खरेल
Khatiwada	खतिवडा
Kheem	खीम
Khelanand	खेलानन्द
Khem	खेम
Khemnath	खेमनाथ
Khemraj	खेमराज
Kheshu	खेसु
Khet	खेत
Khetulal	खेतुलाल
Khila	खिला
Khilendra	खिलेन्द्र
Khim	खिम
Khimananda	खिमानन्द
Khimnath	खिमनाथ
Khobindra	खोबिन्द्र
Khom	खोम
Khoma	खोमा
Khop	खोप
Khovindra	खोविन्द्र
Khum	खुम
Khuman	खुमान
Khumananda	खुमानन्द
Khurshed	खुर्सेद
Khusbu	खुस्बु
Khushi	खुशी
Khushilal	खुशीलाल
Khushnandan	खुशनन्दन
Khusi	खुसी
Khyam	खयाम
Kichah	किचाह
Kimilsung	किमिल्सुङ
Kimon	किमोन
Kiran	किरण
Kiroj	किरोज
Kirtan	कीर्तन
Kirti	कीर्ति
Kisan	किसान
Kishan	किशन
Kishor	किशोर
Kishore	किशोर
Kishori	किशोरी
Kishwor	किश्वर
Kismat	किस्मत
Kisun	किसुन
Kobid	कोबिड
Kobit	कोबिट
Koju	कोजु
Komal	कोमल
Komananda	कोमानन्द
Kosh	कोश
Koshal	कोशल
Koshish	कोशिस
Koushal	कौशल
Koushlendra	कौशलेन्द्र
Kreeti	क्रेट
Krijan	क्रिजन
Krijon	क्रिजोन
Krimesh	क्रिमेश
Krinjjwal	कृष्णज्वल
Kripa	कृपा
Kripan	कृपाण
Kripanand	कृपानन्द
Kripananda	कृपानन्द
Kripashwar	कृपाश्वर
Kripendra	कृपेन्द्र
Kripesh	कृपेश
Krish	कृष
Krisha	कृषा
Krishal	कृषल
Krishan	कृष्ण
Krishant	कृष्ण
Krishbold	कृष्णबोल्ड
Krishman	कृष्ण
Krishn	कृष्ण
Krishna	कृष्ण
Krishnanand	कृष्णानन्द
Krishnandan	कृष्णन्दन
Krishodar	कृष्णदर
Krishu	कृषु
Kristal	क्रिस्टल
Kritagya	कृतज्ञ
Kritam	कृतम्
Kritan	कृतन
Kritendra	कृतेन्द्र
Kritesh	कृतेश
Kriti	कृति
Kritika	कृतिका
Kritish	कृतिस
Kritya	कृति
Krripesh	कृपेश
Ksheetiz	क्षेत्रिज
Kshetraphal	क्षेत्रफल
Kshiring	क्षीरिङ
Kshiteej	क्षितिज
Kshitij	क्षितिज
Kshitish	क्षितिस
Kshitiz	क्षितिज
Kshityz	क्षितिज
Ksitiz	Ksitiz
Kuber	कुबेर
Kul	कुल
Kulananda	कुलानन्द
Kulbhusan	कुलभूषण
Kulchandra	कुलचन्द्र
Kuldeep	कुलदीप
Kuldip	कुलदिप
Kulendra	कुलेन्द्र
Kulhari	कुल्हारी
Kulin	कुलिन
Kulman	कुलमान
Kumar	कुमार
Kumari	कुमारी
Kumba	कुम्बा
Kumbha	कुम्भ
Kumod	कुमोद
Kumraj	कुमारराज
Kumud	कुमुद
Kunal	कुणाल
Kundal	कुण्डल
Kundan	कुन्दन
Kunga	कुङ्गा
Kunj	कुञ्ज
Kunjan	कुञ्जन
Kunjung	कुञ्जुङ
Kunsang	कुनसाङ
Kusal	कुसल
Kusananda	कुसानन्द
Kusang	कुसाङ
Kuseshwar	कुसेश्वर
Kush	कुश
Kushagra	कुशाग्र
Kushal	कुशल
Kushan	कुशन
Kushang	कुशाङ
Kushas	कुशास
Kusheshwar	कुशेश्वर
Kushum	कुसुम
Kusmita	कुस्मिता
Kusum	कुसुम
Kusumakar	कुसुमाकर
Kyaron	क्यारोन
Kyawsoe	Kyawsoe
Lab	प्रयोगशाला
Laba	लाबा
Ladhu	लधु
Lagat	लगत
Lakesh	लकेश
Lakhan	लखन
Lakhindra	लखिन्द्र
Lakpa	लाक्पा
Lakshman	लक्ष्मण
Lakshmeshwar	लक्ष्मेश्वर
Lakshmi	लक्ष्मी
Lal	लाल
Lalan	लालन
Lalbabu	लालबाबु
Lalendra	लालेन्द्र
Lalijan	लालिजन
Lalit	ललित
Lalita	ललिता
Laliteswer	ललितेश्वर
Lalitya	ललिता
Lalu	लालु
Laman	लमान
Lamichhane	लामिछाने
Lanka	लंका
Lasata	लसाता
Laskey	लास्की
Latip	ल्याटिप
Lav	लव
Lava	लाभा
Lavalesh	Lavales
Lavamani	लवमणि
Lawa	कानून
Laxaman	लक्ष्मण
Laxman	लक्ष्मण
Laxmeshwar	लक्ष्मेश्वर
Laxmi	लक्ष्मी
Layash	लयश
Leenesh	लीनेश
Lek	लेक
Lekh	लेख
Lekha	लेखा
Lekhanath	लेखनाथ
Lekharaj	लेखराज
Lekhnath	लेखनाथ
Lenin	लेनिन
Lenish	लेनिस
Libas	लिबास
Libindra	लिबिन्द्र
Ligaj	लिगाज
Lijesh	लिजेश
Likan	लिकन
Lil	लिल
Lila	लिला
Liladhar	लीलाधर
Lilamani	लीलामणि
Lilaram	लीलाराम
Lilesh	लिलेश
Lincoln	लिंकन
Linson	लिनसन
Linus	लिनस
Lisa	लिसा
Liza	लिजा
Lizan	लिजान
Lobsang	लोबसाङ
Lochan	लोचन
Lok	लोक
Lokap	लोकाप
Loken	लोकेन
Lokendra	लोकेन्द्र
Lokesh	लोकेश
Lokeshwor	लोकेश्वर
Lokhari	लोकारी
Lokmani	लोकमणी
Loknath	लोकनाथ
Lokraj	लोकराज
Lomas	लोमास
Lomash	लोमास
Looja	लुजा
Loojah	लुजाह
Loosun	Loosun
Looza	लुजा
Lopsang	लोप्साङ
Lotus	कमल
Louis	लुइस
Lov	प्रेम
Love	माया
Lucent	लुसेन्ट
Lucky	भाग्यमानी
Lujina	लुजिना
Lujja	लुज्जा
Luka	लुका
Lukash	लुकास
Lumani	लुमानी
Lumanti	लुमन्ती
Lunar	चन्द्र
Luniva	लुनिभा
Lusan	लुसान
Luv	लभ
Luwindhup	लुविन्धुप
M.d.	M.d
Mabi	माबी
Mabin	माबिन
Mabindra	मबिन्द्र
Machakaji	मचाकजी
Machhendra	मछेन्द्र
Madan	मदन
Madav	माधव
Madhab	माधव
Madhav	माधव
Madhu	मधु
Madhuban	मधुवन
Madhukar	मधुकर
Madhumala	मधुमाला
Madhup	मधुप
Madhurendra	मधुरेन्द्र
Madhuresh	मधुरेश
Madhuri	माधुरी
Madhushree	मधुश्री
Madhusudan	मधुसूदन
Madhusudha	मधुसुधा
Madhusudhan	मधुसूदन
Madip	मादिप
Mahabharat	महाभारत
Mahabir	महावीर
Mahadev	महादेव
Mahajan	महाजन
Mahamad	महमद
Mahamaya	महामाया
Mahammad	मोहम्मद
Mahanand	महानन्द
Mahananda	महानन्द
Maharjan	महर्जन
Mahasatwo	महासातव
Mahasek	महासेक
Mahato	महतो
Mahedra	महेन्द्र
Mahendra	महेन्द्र
Mahesh	महेश
Maheshower	महेश्वर
Maheshwar	महेश्वर
Maheshwor	महेश्वर
Maheswar	महेश्वर
Maheswor	महेश्वर
Mahim	महिम
Mahima	महिमा
Mahip	महिप
Mahit	महित
Mahotsav	महोत्सव
Majbullah	मजबुल्लाह
Makbul	मकबुल
Makeshwar	मकेश्वर
Makju	मक्जु
Maktendra	मक्तेन्द्र
Malah	मलाच
Malcolm	माल्कम
Maleena	मलेना
Malesh	मलेश
Malika	मलिका
Malisha	मलिशा
Mallik	मल्लिक
Mamata	ममता
Mamina	मोमिना
Mamta	ममता
Man	मान्छे
Mana	मन
Manaandiny	मानन्दिनी
Manab	मानब
Manahari	मनहरी
Manaj	व्यवस्थापन गर्नुहोस्
Manamohan	मनमोहन
Manan	मनन
Manandhar	मानन्धर
Manaraj	मनराज
Manarath	मनारथ
Manas	मानस
Manash	मनस
Manasi	मानसी
Manaswi	मनस्वी
Manav	मानव
Manbahadur	मानबहादुर
Manchan	मञ्चन
Mandalkusheshwar	मण्डलकुशेश्वर
Mandar	मन्डर
Mandeep	मनदीप
Mandil	मण्डिल
Mandip	मण्डिप
Maneesh	मनीश
Manendra	मनेन्द्र
Manesh	मनेश
Manga	मङ्गा
Mangal	मंगला
Mangesh	मंगेश
Mani	मणि
Manij	मनिज
Manik	माणिक
Manika	मनिका
Manil	मनिला
Manina	मनिना
Manindra	मनिन्द्र
Manir	मनीर
Maniram	मणिराम
Maniratna	मणिरत्न
Manis	मनिस
Manisa	मनिसा
Manish	मनिष
Manisha	मनिषा
Manishtra	मनिष्ट्रा
Manistha	मनिष्ट
Manit	मनित
Manita	मनिता
Manize	मनाइज गर्नुहोस्
Manjan	मञ्जन
Manjari	मञ्जरी
Manjeet	मञ्जित
Manjesh	मञ्जेश
Manjik	मन्जिक
Manjil	मञ्जिल
Manjila	मञ्जिला
Manjip	मनजिप
Manjish	मञ्जिश
Manjit	मनजित
Manju	मञ्जु
Manjul	मञ्जुल
Manjur	मन्जुर
Mankaji	मनकाजी
Mankshwar	मङ्केश्वर
Manmohan	मनमोहन
Mann	मान
Mannu	मन्नु
Manohar	मनोहर
Manoj	मनोज
Manojit	मनोजित
Manor	मनोर
Manoranjan	मनोरञ्जन
Manorath	मनोरथ
Manraj	मनराज
Mansoon	मनसुन
Mansubh	मनसुभ
Mantosh	मन्तोष
Manu	मनु
Manup	म्यानअप
Manzil	मन्जिल
Marisha	मारिशा
Markoni	मार्कोनी
Marshal	मार्शल
Martina	मार्टिना
Masihuddin	मसिहुद्दीन
Mathura	मथुरा
Matish	मतिस
Matrika	मातृका
Matsyendra	मत्स्येन्द्र
Matu	मातु
Matuk	Matuk
Mausam	मौसम
Mausham	मौसम
Maya	माया
Mayank	मयङ्क
Mayukh	मयुख
Mayush	मायुस
Md	मो
Md.	मो.
Md.alsahud	मो अलसाहुद
Md.inzamam	मो. इन्जामाम
Md.kaiyum	मो कैयुम
Md.mustak	मो मुस्ताक
Mdmazammil	Mdmazammil
Mdmozammil	मोजम्मिल
Mebish	मेबिस
Medan	मेदान
Medini	मेदिनी
Meen	मीन
Meena	मीना
Meg	मेग
Megesh	मेगेश
Megh	मेघ
Megha	मेघा
Megharaj	मेघराज
Meghendra	मेघेन्द्र
Meghraj	मेघराज
Meghu	मेघु
Mehang	महङ
Meharaj	महराज
Mehgaraj	मेहगराज
Mekh	मेख
Mekha	मक्का
Meman	मेमन
Menaka	मेनका
Mend	सुधार गर्नुहोस्
Menuka	मेनुका
Meraj	मेराज
Merina	मेरिना
Merishna	मेरिश्ना
Merit	योग्यता
Merry	रमाइलो
Mesh	जाल
Meynam	मेयनम
Mgsingh	मङ्गसिंह
Mhohan	मोहन
Mibek	मिबेक
Mibun	मिबुन
Michael	माइकल
Midhan	मिधान
Midhir	मध्यर
Migmar	मिग्मार
Mihir	मिहिर
Mijan	मिजन
Mijas	मिजास
Mijash	मिजास
Mikal	मिकाल
Mikma	मिक्मा
Miksen	मिकसेन
Mikuhang	मिकुहाङ
Milan	मिलान
Milap	मिलाप
Milesh	माइल
Milinda	मिलिन्दा
Mim	मिम
Mimamsa	मिमांसा
Miman	मिमन
Mimansha	मिमांशा
Min	न्यूनतम
Mina	मिना
Minakshi	मिनाक्षी
Minesh	मिनेश
Mingja	मिङ्जा
Mingma	मिङ्मा
Minindra	मिनिद्रा
Mirage	मिराज
Miraj	मिराज
Miran	मिरान
Mirgendra	मिरगेन्द्र
Mirinal	मिरिनल
Miroj	मिरोज
Misan	मिसन
Mishal	मिसाल
Mishan	मिसन
Mishek	मिशेक
Mishra	मिश्रा
Mission	मिशन
Mitab	मिताब
Mitalesh	मितालेश
Mitesh	मितेश
Mithalesh	मिथलेश
Mithilesh	मिथिलेश
Mithlesh	मिथलेश
Mithun	मिथुन
Miton	मिटन
Mitra	मित्रा
Mitraghan	मित्रघन
Mitralal	मित्राल
Mobin	मोबिन
Moha	मोह
Mohamad	मोहम्मद
Mohammad	मोहम्मद
Mohammadzeaul	मोहम्मदजौल
Mohammed	मोहम्मद
Mohan	मोहन
Mohanish	मोहनीश
Moharaj	मोहराज
Mohdasif	मोहदासिफ
Mohendra	मोहेन्द्र
Mohir	मोहिर
Mohit	मोहित
Mohmmad	मोहम्मद
Mohsin	मोहसिन
Moinuddin	मोइनुद्दिन
Mokshendra	मोक्षेन्द्र
Mon	सोम
Mona	मोना
Moni	मोनी
Monica	मोनिका
Monika	मोनिका
Monima	मोनिमा
Monish	मोनिस
Monoj	मोनोज
Monu	मोनु
Moon	चन्द्रमा
Mosaheb	मोसाहब
Moses	मोशा
Moti	मोती
Motilal	मोतीलाल
Motiullah	मोतिउल्लाह
Motra	मोत्रा
Mousam	मौसम
Mridul	मृदुल
Mrigendra	मृगेन्द्र
Mrinal	मृणाल
Mritunjay	मृत्युञ्जय
Mrityunjay	मृत्युञ्जय
Mubarak	मुबारक
Mubin	मुबिन
Mudesh	मुदेश
Mudhvari	मुधवारी
Mudita	मुदिता
Mugal	मुगल
Mujahid	मुजाहिद
Mukendra	मुकेन्द्र
Mukesh	मुकेश
Mukeshkumar	मुकेश कुमार
Muklesh	मुक्लेश
Mukta	मुक्ता
Mukti	मुक्ति
Muktinath	मुक्तिनाथ
Mukul	मुकुल
Mukund	मुकुन्द
Mukunda	मुकुन्द
Mukundahari	मुकुन्दहरी
Mumi	ममी
Mun	मुन
Muna	मुना
Munal	मुनाल
Muni	मुनि
Munib	मुनिब
Munil	मुनिल
Munindra	मुनिन्द्र
Munish	मुनिष
Munna	मुन्ना
Munnesh	मुनीश
Murali	मुरली
Muralidhar	मुरलीधर
Murari	मुरारी
Murlee	मुर्ली
Murli	मुरली
Muskan	मुस्कान
Mustafa	मुस्तफा
Nab	Nab
Naba	नाबा
Nabal	नाबाल
Nabaraj	नवराज
Nabeen	नविन
Nabin	नबिन
Nabinda	नवीन्दा
Nabindra	नबिन्द्र
Nabita	नविता
Nabo	नाबो
Nabraj	नवराज
Nadeem	नदीम
Nadim	नदिम
Nagarik	नागरिक
Nagendra	नागेन्द्र
Nagesh	नागेश
Nageshor	नागेश्वर
Nageshwar	नागेश्वर
Nageshwor	नागेश्वर
Nagina	नगिना
Nagmanath	नागमनाथ
Nahakul	नहकुल
Najabullah	नजाबुल्लाह
Najam	नजम
Najim	नाजिम
Nakul	नकुल
Nal	नल
Nalin	नलिन
Nam	नाम
Nama	नामा
Namakar	नामकार
Naman	नामान
Namaraj	नमराज
Namas	नमस
Nameru	नामरु
Namin	नमिन
Namindra	नमिन्द्र
Namish	नमिष
Namnit	नम्रित
Namosi	नमोसी
Namu	नमु
Nancy	न्यान्सी
Nand	नन्द
Nanda	नन्द
Nandalal	नन्दलाल
Nandan	नन्दन
Nandeshwar	नन्देश्वर
Nandeshwor	नन्देश्वर
Nangjang	नाङजाङ
Nani	नानी
Naniram	नानिराम
Nanish	नानिस
Nar	नार
Nara	नारा
Narad	नारद
Narahari	नरहरि
Narakanta	नरकान्त
Naran	नारान
Narayan	नारायण
Naren	नरेन
Narendra	नरेन्द्र
Naresh	नरेश
Narhari	नरहरि
Narinder	नरेन्द्र
Narottam	नरोत्तम
Narsang	नरसाङ
Naseeb	नसीब
Nashib	नशिब
Nashiv	नाशिव
Nasi	नासी
Nasib	नसिब
Nasibul	नसिबुल
Nasip	नसिप
Nasiv	नासिभ
Nasrullah	नसरुल्लाह
Nati	नाटी
Nation	राष्ट्र
Nausad	नौसाद
Nav	Nav
Nava	Nava
Navalok	नवलोक
Navaraj	नवराज
Naveen	नवीन
Navin	नविन
Navneet	नवनीत
Navnit	नवनीत
Navraj	नवराज
Naw	नयाँ
Nawa	नवा
Nawadeep	नवदीप
Nawal	नवल
Nawang	नवाङ
Nawaraj	नवराज
Nawesh	नवेश
Nawin	नविन
Nawlesh	नवलेस
Nawnit	नवनित
Nawraj	नवराज
Nayan	नयन
Nearoj	निरोज
Needesh	आवश्यकता
Neeket	नीकेत
Neel	नील
Neelan	नीलन
Neelesh	निलेश
Neema	निमा
Neemesh	निमेष
Neepun	निपुन
Neer	नीर
Neerad	नीरद
Neeraj	नीरज
Neerajan	नीरजन
Neerav	नीरव
Neeschal	निश्चल
Neeta	नीता
Negendra	नेगेन्द्र
Neha	नेहा
Nehal	नेहल
Nejar	नेजार
Nekesh	नेकेश
Neku	नेकु
Neliya	नेलिया
Nelsan	नेल्सन
Nemi	नेमी
Nemish	नेमिस
Nepal	नेपाल
Nepoleon	नेपोलियन
Nepoliyan	नेपोलियन
Nerish	नेरिश
Neshan	नेशन
Netra	नेत्रा
Nettra	नेत्र
Neukesh	न्युकेश
Neupane	न्यौपाने
Newjan	न्युजन
Newton	न्यूटन
Ngema	Ngema
Ngima	Ngima
Ngo	Ngo
Ngwan	Ngwan
Nhishesh	निशेष
Nhuchhe	नुछे
Nhuchhen	नुचेन
Nhuja	नुजा
Niaz	नियाज
Niba	निबा
Nibash	निबास
Nibesh	निबेश
Nickle	निकल
Nicol	निकोल
Nidar	निदर
Nidesh	निदेश
Nifesh	निफेस
Nigam	निगम
Nihal	निहाल
Nihar	निहार
Niharika	निहारिका
Nihit	निहित
Nijal	निजल
Nijam	निजम
Nijan	निजन
Nijel	निजेल
Nijendra	निजेन्द्र
Nijesh	निजेश
Nijjal	निज्जल
Nijjwal	निज्जवल
Niju	निजु
Nikash	निकाश
Niken	निकेन
Nikesh	निकेश
Nikhil	निखिल
Niki	निकी
Nikil	निकिल
Nikila	निकिला
Nikit	निकित
Nikita	निकिता
Nikki	निक्की
Nikshan	निक्षन
Nikung	निकुङ
Nikunj	निकुञ्ज
Nikunjan	निकुञ्जन
Niky	निकी
Nil	शून्य
Nila	निला
Nilab	निलाब
Nilam	नीलम
Nilambar	निलाम्बर
Nilan	निलन
Nilav	निलाव
Nilendra	निलेन्द्र
Nilesh	निलेश
Nilima	निलिमा
Nilkantha	नीलकण्ठ
Nilmani	नीलमणि
Nilok	निलोक
Nilonchan	निलोचन
Nilotpal	निलोत्पल
Nilu	निलु
Nim	निम
Nima	निमा
Nimbus	निम्बस
Nimesh	निमेश
Nimish	निमिष
Nimit	निमित
Nimoh	निमोह
Nimte	निम्ते
Ninda	निंदा
Ningmar	निङ्मार
Ninja	निन्जा
Nipesh	निपेश
Nippon	निप्पन
Nipun	निप्पन
Nipurna	निपूर्ण
Nir	निर
Nirab	निरब
Niraj	निरज
Nirajan	निरजन
Nirak	निरक
Nirakar	निराकार
Niramal	निर्मल
Niran	निरन
Niranjan	निरञ्जन
Nirav	निरव
Nirdeep	निर्दीप
Nirdesh	निर्देश
Nirdosh	निर्दोष
Niren	निरेन
Nirendra	निरेन्द्र
Nirendraman	निरेन्द्रमान
Niresh	निरेश
Nirgun	निर्गुण
Nirjal	निर्जल
Nirjan	निर्जन
Nirjara	निर्जरा
Nirjhar	निर्झर
Nirjung	निर्जंग
Nirmal	निर्मल
Nirmala	निर्मला
Nirman	निर्माण
Nirmit	निर्मित
Nirnaya	निर्णाय
Niroj	निरोज
Nirol	निरोल
Niros	निरोस
Niroula	निरौला
Nirpesh	निर्पेश
Niruj	निरुज
Nirusha	निरुषा
Nirvan	निर्वाण
Nirvay	निर्भय
Nirvik	निर्विक
Nirwan	निर्वाण
Nisan	निसान
Nischal	निश्चल
Nischay	निश्चय
Nischaya	निश्चय
Nischchhal	निश्चल
Nischit	निश्चित
Nisesh	निसेश
Nisha	निशा
Nishaj	निसज
Nishal	निशाल
Nishan	निशान
Nishant	निशान्त
Nishanta	निशान्त
Nishar	निशार
Nishchal	निश्चल
Nishchay	निश्चय
Nishchhal	निश्चल
Nished	निश्ड
Nishedh	निशेष
Nishee	निशी
Nisheem	निशिम
Nishes	निशेस
Nishesh	निशेष
Nishith	निशिथ
Nishkarsha	निष्कर्षा
Nishma	निश्मा
Nishu	निशु
Nishub	निशुब
Niskarsh	निस्कर्ष
Niskarsha	निस्कर्ष
Nissan	निसान
Nisseem	निसिम
Nistu	निस्तु
Nitam	नितम
Nitant	नितान्त
Nitanta	नितान्ता
Niten	नितेन
Nitendra	नितेन्द्र
Nites	नाइट्स
Nitesh	नितेश
Niteshwar	नितेश्वर
Nitikesh	नितिकेश
Nitin	नितिन
Nitish	नितिश
Nitisha	नितिशा
Nitu	नितु
Nitya	नित्या
Nityanand	नित्यानन्द
Nivesh	निवेश
Niwa	निवा
Niwas	निवास
Niwash	निवाश
Nixon	निक्सन
Niyam	नियम
Nobal	नोबल
Nobel	नोबेल
Nobheswar	नोभेश्वर
Nom	नोम
Noman	नर्मन
Noor	नूर
Noore	नूर
Noorja	नूरजा
Noorul	नुरुल
Nootan	नूटन
Norbu	नोर्बु
Norden	नर्डेन
Noshan	नोशन
Novel	उपन्यास
Novin	नोभिन
Noze	नाक
Nrip	नृप
Nripendra	नृपेन्द्र
Nripesh	नृपेश
Nrpendra	नरपेन्द्र
Nujhat	नुजात
Nukesh	नुकेश
Numakhar	नुमाखर
Numan	नुमान
Nunuhang	नुनुहाङ
Nupu	नुपु
Nuraj	नुराज
Nush	नुस
Nutan	नूतन
Nyaupanem	न्यौपनेम
Oasis	ओएसिस
Oat	ओट
Obiram	ओबिराम
Oblique	ओब्लिक
Obyesh	ओब्येस
Ocean	महासागर
Oja	ओजा
Ojan	ओजन
Ojash	ओजस
Ojaswi	ओजस्वी
Ojesh	ओजेश
Okil	ओकिल
Om	ओम
Oman	ओमान
Ombikram	ओम्बिकराम
Omhari	ओमहारी
Omkar	ओमकार
Omkrishna	ओमकृष्ण
Omnath	ओमनाथ
Omprakash	ओमप्रकाश
Omraj	ओमराज
Onam	ओणम
Onash	ओनास
Onus	ओनस
Opendra	ओपनड्रा
Optics	अप्टिक्स
Orish	ओरिस
Orpheus	ओर्फियस
Orzoraj	ओर्जोराज
Osan	ओसान
Oshan	महासागर
Oshis	ओशिस
Osho	ओशो
Owen	ओवेन
Ozaswei	Ozaswei
Ozosh	ओजोस
Paban	पवन
Paben	पबेन
Pabin	पबिन
Pabindra	पविन्द्र
Pabitra	पवित्रा
Padam	पदम
Padama	पद्मा
Padamendra	पदमेन्द्र
Padamraj	पदमराज
Padma	पद्मा
Padmadeep	पद्मदीप
Pahad	पहाड
Pahari	पहारी
Palash	पलाश
Palden	पाल्देन
Palistha	पालिस्टा
Pallab	पल्लब
Pallav	पल्लव
Pallaw	पल्लव
Pallawi	पल्लवी
Palson	पाउलसन
Pamitosh	पामितोष
Pandav	पाण्डवहरू
Pandey	पाण्डे
Pandit	पण्डित
Pandu	पाण्डु
Pankaj	पंकज
Panna	पन्ना
Pant	पन्त
Panthee	पान्थिया
Pappu	पप्पु
Papu	पपु
Papular	पपुलर
Parag	पराग
Parajuli	पराजुली
Parajwal	पराज्वल
Param	परम
Paramanand	परमानन्द
Parameshor	परमेश्वर
Parameshwar	परमेश्वर
Parameshwor	परमेश्वर
Paranjaya	पराञ्जय
Paras	पारस
Parasar	परासर
Parash	पारस
Parashar	पराशर
Parashmani	परशमणि
Parasmani	पारसमणी
Parbat	पर्वत
Parbati	पार्वती
Parbhakar	परभाकर
Pareekshit	परीक्षित
Paribartan	परिवर्तन
Paribesh	परिवेश
Parichit	परिचित
Parikrama	परिक्रमा
Parikshit	परीक्षित
Parina	परिना
Parinav	परिणव
Parishad	परिषद्
Parishrut	परिश्रुत
Paritosh	परितोष
Parivesh	परिवेश
Pariwesh	परिवेश
Parkash	प्रकाश
Parmanand	परमानन्द
Parmar	परमार
Parmendra	परमेन्द्र
Parmesh	परमेश
Parmeshwar	परमेश्वर
Parmila	परमिला
Parshu	परशु
Parshuram	परशुराम
Parsuram	परशुराम
Partap	प्रताप
Partha	पार्थ
Paru	पारु
Parvat	पार्वत
Parwat	पार्वत
Parwej	परवेज
Parwes	परवेस
Parwez	परवेज
Pasang	पासाङ
Pascal	पास्कल
Pasee	पासी
Pashan	पाषाण
Pashupati	पशुपति
Pathak	पाठक
Paudesh	पौडेस
Paudyal	पौड्याल
Paurakh	पौरख
Paurakha	पौरखा
Pavan	पवन
Pavel	पावेल
Pawan	पवन
Pawitraman	पवित्रमण
Payoj	पायोज
Pearlson	पर्लसन
Pecel	Pecel
Peetambar	पीताम्बर
Peeyush	पियुस
Pema	पेमा
Pemba	पेम्बा
Perish	नाश
Pesal	पेसल
Peter	पिटर
Peyush	पेयुस
Phalendra	फलेन्द्र
Phan	फान
Phanendra	फणेन्द्र
Phanindra	फणीन्द्र
Phaom	फाओम
Pharindra	फरिन्द्र
Phatta	फट्टा
Philemon	फिलेमोन
Phiroj	फिरोज
Phool	फुल
Phoolchand	फूलचन्द
Phulu	फुलु
Pidison	पिडिसन
Pikesh	पिकेश
Pinkey	पिंकी
Pinky	पिंकी
Pintu	पिन्टु
Pipan	पिपन
Pitambar	पीताम्बर
Pitamber	पीताम्बर
Pitar	पितर
Piush	पियुस
Piya	पिया
Piyush	पियुष
Piyusha	पियुषा
Pl	Pl
Poba	पोबा
Pokharaj	पोखराज
Pokharel	पोखरेल
Pokhraj	पोखराज
Pokhrel	पोखरेल
Pooja	पुजा
Poojan	पूजन
Poonam	पूनम
Poorna	पूर्ण
Popular	लोकप्रिय
Poshak	पोषक
Poshan	पोशन
Posraj	पोसराज
Post	पोस्ट
Poudel	पौडेल
Pourush	पौरुष
Prabachan	प्रवचन
Prabaha	प्रभा
Prabal	प्रबल
Prabash	प्रभास
Prabee	प्रबी
Prabeen	प्रवीण
Prabeg	प्राबेग
Prabendra	प्रबेन्द्र
Prabesh	प्रवेश
Prabhab	प्रभाब
Prabhakar	प्रभाकर
Prabhaker	प्रभाकर
Prabhanand	प्रभानन्द
Prabhas	प्रभास
Prabhash	प्रभास
Prabhat	प्रभात
Prabht	प्रभात
Prabhu	प्रभु
Prabhushan	प्रभुषण
Prabidhi	प्रबिधि
Prabij	प्रबिज
Prabin	प्रविन
Prabind	प्रविन्द
Prabindra	प्रवीन्द्र
Prabinja	प्रबिञ्ज
Prabip	प्रविप
Prabir	प्रबिर
Prabish	प्रबिस
Prabodh	प्रबोध
Prabuddha	प्रबुद्ध
Prachan	प्रचन
Prachand	प्रचण्ड
Prachanda	प्रचण्ड
Prachandra	प्रचण्ड
Prachar	प्रचार
Prachet	प्रचेत
Pradeen	प्रदीन
Pradeep	प्रदीप
Pradeeplal	प्रदीपलाल
Pradej	प्राग
Pradep	प्रदीप
Pradesh	प्रदेश
Pradeshi	प्रदेशी
Pradhan	प्रधान
Pradhananga	प्रधानाङ्ग
Pradhuman	प्रद्युमन
Pradhumna	प्रद्युम्न
Pradhyumna	प्रद्युम्न
Pradip	प्रदीप
Pradish	प्रदेश
Pradumna	प्रद्युम्न
Pradyuman	प्रद्युम्न
Pradyumma	प्रद्युम्मा
Pradyumna	प्रद्युम्न
Prafful	प्रफुल्ल
Praful	प्रफुल्ल
Prafulla	प्रफुल्ल
Pragam	प्रगाम
Pragati	प्रगति
Pragatishil	प्रगतिशील
Pragesh	प्रगेश
Pragun	प्रागन
Pragya	प्रज्ञा
Pragyan	प्रज्ञान
Pragyesh	प्रज्ञेश
Praharsha	प्रहर्ष
Prahlad	प्रह्लाद
Praj	प्राज
Praja	प्रजा
Prajal	प्रजल
Prajan	प्रजन
Prajapati	प्रजापति
Prajay	प्रजय
Prajaya	प्रजय
Prajeena	प्रजिना
Prajesh	प्रजेश
Prajin	प्रजिन
Prajit	प्रजित
Prajjawal	प्रज्जवल
Prajjol	प्रज्जोल
Prajjwal	प्रज्वल
Prajjwol	प्रज्ज्वोल
Prajol	प्रजोल
Prajon	प्रजोन
Prajowal	प्रजोवल
Prajul	प्राजुल
Prajun	प्रजुन
Prajwal	प्रज्वल
Prajwol	प्रज्वल
Prakakash	प्रकाश
Prakanda	प्रकाण्ड
Prakar	प्राकार
Prakash	प्रकाश
Prakashjit	प्रकाशजीत
Prakat	प्रकट
Prakesh	प्रकाश
Prakeshet	प्रकेशत
Prakhal	प्रकाल
Prakhar	प्रखर
Prakhyat	प्रख्यात
Prakit	प्राकित
Prakritee	प्रकृति
Prakriti	प्रकृति
Praksash	प्रकाश
Pralab	प्रलब
Pralad	प्रलाद
Praladh	प्रलाद
Pralaya	प्रलय
Pralesh	प्रलेश
Pralhad	प्रल्हाद
Pralin	प्रालिन
Pralish	प्रलिश
Pramanand	प्रमानन्द
Pramananda	प्रमानन्द
Pramen	प्रमेन
Pramendra	प्रमेन्द्र
Pramesh	प्रमेश
Prameshwar	प्रमेश्वर
Prameshwor	प्रमेश्वर
Pramil	प्रमिल
Pramila	प्रमिला
Pramin	प्रमिन
Pramish	प्रमिश
Pramistha	प्रमिष्ठ
Pramit	प्रमित
Pramithus	प्रमिथस
Pramod	प्रमोद
Pramodit	प्रमोदित
Pramodman	प्रमोदमान
Pran	प्राण
Pranab	प्रणव
Pranam	प्रणाम
Pranav	प्रणव
Pranay	प्रणय
Pranaya	प्रणया
Pranayan	प्रणयन
Praneel	प्रणिल
Pranesh	प्रणेश
Pranij	प्रणिज
Pranik	प्रणिक
Pranil	प्रणिल
Pranish	प्रणिश
Pranisha	प्रनिशा
Pranit	प्रणित
Pranjal	प्रांजल
Prannab	प्रणव
Prannav	प्रणव
Pranodan	प्रणोदन
Pranoy	प्रणय
Pranshu	प्रांशु
Pransu	प्रान्सु
Prantosh	प्रान्तोस
Pranuj	प्रानुज
Pranya	प्रन्या
Praphulla	प्रफुल्ल
Prarora	प्ररोरा
Prarup	प्रारुप
Prasamsa	प्रसंसा
Prasamsha	प्रसंशा
Prasan	प्रसन
Prasanga	प्रसाङ्ग
Prasanna	प्रसन्न
Prasansha	प्रसंशा
Prasant	प्रशान्त
Prasanta	प्रशान्त
Prasha	प्रशा
Prashan	प्राशन
Prashandip	प्रशानदीप
Prashanga	प्रशाङ्ग
Prashann	प्रशान
Prashanna	प्रशन्ना
Prashant(tuladhar)	प्रशान्त (तुलाधर)
Prashant	प्रशान्त
Prashanta	प्रशान्त
Prasheen	प्रशिन
Prashidda	प्रशिद्ध
Prashiddha	प्रसिद्ध
Prashidha	प्रशिधा
Prashil	प्रशिल
Prashim	प्रशिम
Prashis	प्राशिस
Prashish	प्रशिस
Prashit	प्रशित
Prashna	प्रशना
Prashraya	प्रश्रय
Prashrit	प्रशित
Prashun	प्रशुन
Prasiddha	प्रसिद्ध
Prasidha	प्रसिधा
Prasil	प्रसिल
Prasis	प्रासिस
Prasish	प्रशिस
Prasoon	प्रसुन
Prastab	प्रस्ताब
Prastav	प्रस्ताव
Prastika	प्रास्तिका
Prastut	प्रस्तुत
Prasun	प्रसुन
Prasuna	प्रसुना
Praswish	प्रश्विस
Pratap	प्रताप
Prateek	प्रतीक
Pratham	प्रथम
Pratibh	प्रतिभा
Pratibha	प्रतिभा
Pratic	व्यावहारिक
Pratick	प्राटिक
Pratigya	प्रतिज्ञा
Pratik	प्रतीक
Pratikar	प्रतिकार
Pratikchhya	प्रतिक्षा
Pratiksha	प्रतिक्षा
Pratikshya	प्रतिक्षा
Pratima	प्रतिमा
Pratinidhi	प्रतिनिधि
Pratirodh	प्रतिरोध
Pratish	प्रतिश
Pratistha	प्रतिष्ठा
Pratisthit	प्रतिष्ठित
Pratit	प्रतित
Pratul	प्रतुल
Pratyul	प्रत्युल
Pratyush	प्रत्युष
Prava	प्रवा
Pravakar	प्रभाकर
Praval	प्रवल
Pravash	प्रवेश
Pravat	प्रभात
Pravav	प्रभ
Praveen	प्रवीण
Praveer	प्रवीर
Pravej	प्रवेज
Pravesh	प्रवेश
Praveshkar	प्रवेशकर
Pravin	प्रविण
Pravind	प्रविन्द
Pravishan	प्रविशन
Prawal	प्रवल
Prawesh	प्रवेश
Praweshwor	प्रवेश्वर
Prawin	प्रविन
Prawor	प्रावर
Prayag	प्रयाग
Prayas	प्रार्थना
Prayash	प्रार्थना
Prayatna	प्रार्थना
Prayog	प्रयोग
Prayon	प्रार्थना
Prayush	प्रार्थना
Prazol	प्राजोल
Prazwal	प्रज्वल
Preatesh	प्रितेश
Preedep	प्रीदीप
Preeshan	प्रेशान
Preetam	प्रीतम
Preetina	प्रीतिना
Preiz	प्रिज
Prekshan	प्रेक्षन
Prekshya	प्रेक्षा
Prem	प्रेम
Prema	प्रेमा
Premendra	प्रेमेन्द्र
Premhari	प्रेमहरी
Prerak	प्रेरक
Prerna	प्रेरणा
Prerok	प्रिरोक
Preshit	प्रेषित
Priajan	प्रियजन
Prijal	प्रिजल
Prince	राजकुमार
Pritam	प्रीतम
Pritee	प्रिती
Pritesh	प्रितेश
Prithbi	पृथ्वी
Prithivi	पृथ्वी
Prithu	पृथु
Prithvi	पृथ्वी
Pritish	प्रितिश
Pritty	सुन्दर
Priy	प्रिया
Priya	प्रिया
Priyadarshan	प्रियदर्शन
Priyanka	प्रियंका
Priyanshu	प्रियांशु
Priyaranjan	प्रियरञ्जन
Priyash	प्रियस
Priyendra	प्रियेन्द्र
Probin	प्रोबिन
Progesh	प्रोगेस
Progress	प्रगति
Projesh	परियोजना
Projjwol	प्रोज्वल
Projwal	प्रज्वल
Projwol	प्रोज्वल
Promesh	प्रोमेश
Promis	वाचा
Promish	वाचा
Promod	प्रमोड
Proses	प्रक्रिया
Puja	पुजा
Pujan	पुजन
Pujash	पुजास
Pujesh	पुजेश
Pukar	पुकार
Pulik	पुलिक
Pumal	पुमल
Pun	पुन
Punam	पुनम
Punit	पुनित
Punita	पुनिता
Punjan	पुन्जन
Punya	पुण्य
Punyadip	पुण्यदीप
Punyakumar	पुण्यकुमार
Purak	पुरक
Puran	पुराण
Purba	पुर्वा
Purinji	पुरिनजी
Purna	पूर्ण
Purnanda	पूर्णन्दा
Purnendu	पूर्णेन्दु
Purnima	पूर्णिमा
Purshotam	पुरुषोत्तम
Purshottam	पुरुषोत्तम
Pursotam	पुरसोतम
Purswotam	पुरस्वोतम
Puru	पुरु
Purushotam	पुरुषोत्तम
Purushottam	पुरुषोत्तम
Purusotam	पुरुषोत्तम
Purusottam	पुरुषोत्तम
Puruswattam	पुरुषवत्तम
Pushkal	पुष्कल
Pushkar	पुष्कर
Pushp	पुष्प
Pushpa	पुष्पा
Pushpak	पुष्पक
Pushparaj	पुष्पराज
Pushpendra	पुष्पेन्द्र
Pushwant	पुष्पवन्त
Puskal	पुस्कल
Puskar	पुष्कर
Pusp	पुस
Puspa	पुष्पा
Pusparaj	पुष्पराज
Puspendra	पुष्पेन्द्र
Puspmani	पुष्पमणि
Pustam	पुस्तम
Pyakurel	प्याकुरेल
Pyaru	प्यारु
Raaz	राज
Rabendra	रबेन्द्र
Rabeshlal	रबेशलाल
Rabhu	प्रभु
Rabhushan	रभुषण
Rabi	रब्बी
Rabiendra	रवीन्द्र
Rabin	रबिन
Rabina	रबिना
Rabinath	रविनाथ
Rabindar	रबिन्दर
Rabindra	रवीन्द्र
Rabindraa	रवीन्द्र
Rabineshwor	रवीनेश्वर
Rabins	रबिन्स
Rabinson	रोबिन्सन
Rabiroshan	रबिरोशन
Rabison	रबिसन
Rabs	रब्स
Rachaindra	रचन्द्र
Rachan	रचना
Rachana	रचना
Rachhak	रछाक
Rachindra	रचिन्द्र
Rachit	रचित
Rachita	रचिता
Radeep	रादीप
Radesh	रादेश
Radha	राधा
Radhay	राधे
Radhe	राधे
Radhebabu	राधेबाबु
Radheshayam	राधेश्याम
Radheshyam	राधेश्याम
Radhika	राधिका
Ragani	रागानी
Ragen	रागेन
Raghab	राघव
Raghabendra	राघवेन्द्र
Raghav	राघव
Raghbendra	राघबेन्द्र
Raghu	रघु
Raghubar	रघुबर
Raghubendra	रघुबेन्द्र
Raghubir	रघुवीर
Raghunath	रघुनाथ
Raghuveer	रघुवीर
Raghwendra	राघवेन्द्र
Rahem	रहिम
Rahish	रहिश
Rahisha	राहिशा
Rahmi	रहमी
Rahul	राहुल
Rai	राई
Raiesh	राईस
Raish	राइश
Raisha	राइशा
Raiz	राईज
Raj	राज
Raja	राजा
Rajababu	राजाबाबु
Rajan	राजन
Rajani	रजनी
Rajanish	रजनीश
Rajaram	राजाराम
Rajarshi	राजर्षि
Rajat	रजत
Rajav	राजव
Rajbabu	राजबाबु
Rajbhandari	राजभण्डारी
Rajbind	राजबिन्द
Rajdeep	राजदीप
Rajdev	राजदेव
Rajdip	राजदीप
Rajeeb	राजीव
Rajeen	राजिन
Rajeet	राजित
Rajeev	राजीव
Rajenddra	राजेन्द्र
Rajendra	राजेन्द्र
Rajesh	राजेश
Rajeshori	राजेश्वरी
Rajeshwar	राजेश्वर
Rajeshwor	राजेश्वर
Rajgir	राजगीर
Rajib	राजीव
Rajin	राजिन
Rajindra	राजेन्द्र
Rajip	राजिप
Rajiv	राजीव
Rajjan	राजन
Rajjwal	रज्जवल
Rajkishor	राज किशोर
Rajkishore	राजकिशोर
Rajkumar	राजकुमार
Rajmani	राजमणि
Rajnesh	रजनीश
Rajnish	रजनीश
Rajoj	राजोज
Rajson	राजसन
Raju	राजु
Rajwol	राजवोल
Rajya	राज्य
Raken	राकेन
Rakes	रेकहरू
Rakesh	राकेश
Rakil	रकिल
Raksha	रक्षा
Rakshak	रक्षक
Rakshya	रक्षा
Raktim	रक्तिम
Ram	राम
Rama	रामा
Ramagya	रामग्या
Ramakant	रामकान्त
Ramakanta	रमाकान्त
Ramal	रामल
Raman	रमन
Ramana	रमण
Ramanand	रामानन्द
Ramananda	रामानन्द
Ramanshu	रमांशु
Ramanuj	रामानुज
Ramapati	रामापति
Ramashankar	रामाशंकर
Ramashish	रामासिश
Rambabu	रामबाबु
Rambali	रामबली
Rambaran	रामवरण
Rambilas	रामबिलास
Rambishwash	रामविश्वश
Ramchandra	रामचन्द्र
Ramdeep	रामदीप
Ramdhan	रमजान
Ramdhar	रामधर
Ramdrash	रामद्रास
Ramdular	रामदुलर
Ramendra	रामेन्द्र
Ramesh	रमेश
Rameshori	रामेश्वरी
Rameshutoar	रामेसुटोर
Rameshwar	रामेश्वर
Rameshwor	रामेश्वर
Rameswar	रामेश्वर
Rameswor	रामेश्वर
Ramhari	रामहरि
Ramij	रामिज
Ramil	रामिल
Ramila	रमिला
Ramin	रामिन
Ramit	रमित
Ramiz	रमिज
Ramjanam	रामजनम
Ramjee	रामजी
Ramjeevan	रामजीवन
Ramji	रामजी
Ramkewal	रामकेवाल
Ramkishor	राम किशोर
Ramkrishna	रामकृष्ण
Ramlal	रामलाल
Rammani	राममणि
Ramnaresh	रामनरेश
Ramnath	राम नाथ
Ramod	रामोड
Rampati	रामपति
Ramprawesh	रामप्रवेश
Ramprit	रामप्रित
Rampukar	रामपुकर
Ramraj	रामराज
Ramraja	रामराजा
Ramratan	रामरतन
Ramsagar	रामसागर
Ramsharan	रामशरण
Ramshohag	रामशोहाग
Ramsingh	रामसिंह
Ramsinhasan	रामसिंहासन
Ramsnehi	रामस्नेही
Ramsudan	रामसुदन
Ramu	रामु
Ramvidhya	रामविद्या
Ramyudhya	रामयुध्या
Ran	दौडियो
Rana	राणा
Randeep	रणदीप
Randhir	रणधीर
Randish	रान्डिस
Ranendra	रणेन्द्र
Rangnath	रंगनाथ
Rangoon	रंगुन
Ranish	रानीश
Ranjai	रञ्जाई
Ranjan	रञ्जन
Ranjana	रञ्जना
Ranjay	रणजय
Ranjaya	रञ्जय
Ranjeep	रञ्जीप
Ranjeet	रञ्जित
Ranjesh	रञ्जेश
Ranjil	रञ्जिल
Ranjish	रञ्जिश
Ranjit	रञ्जित
Ranjita	रञ्जिता
Ranju	रञ्जु
Rannu	रनु
Ranodeep	रानोदीप
Ranoj	रनोज
Ras	रास
Rasbin	रासबिन
Raseen	रसेन
Rasendra	रसेन्द्र
Rashamkumar	रशमकुमार
Rashan	राशन
Rashel	राहेल
Rashik	रसिक
Rashil	रशिल
Rashim	रशिम
Rashish	रासस
Rashmi	रश्मि
Rashmit	रश्मित
Rashmita	रश्मिता
Rashna	रसना
Rasik	रसिक
Rasil	रसिल
Rasish	रासस
Raskin	रस्किन
Rasmita	रस्मिता
Rasul	रसूल
Ratan	रतन
Ratankaji	रतनकाजी
Rati	रति
Ratish	रास
Ratna	रत्न
Ratnakar	रत्नाकर
Ratnesh	रत्नेश
Ratneshwar	रत्नेश्वर
Rattan	रतन
Raunak	रौनक
Rauniyar	रौनियार
Raushan	रौशन
Raut	राउत
Rav	Rav
Raveen	रविन
Raveendra	रवेन्द्र
Ravi	रवि
Ravikant	रविकान्त
Ravikesh	रविकेश
Ravikiran	रविकिरण
Ravin	रविन
Ravindra	रविन्द्र
Raviraj	रविराज
Ravishankar	रविशंकर
Ravvie	Ravvie
Ray	रे
Rayan	रायन
Raybot	रेबोट
Rayish	राईस
Raytaj	रायताज
Razim	रजिम
Reagon	रेगन
Reason	कारण
Reban	रेबन
Rebant	रिब्यान्ट
Rebanta	रेबन्ता
Rebati	रेबती
Redesh	रेडस
Reedul	Reedul
Reedum	रिडम
Reekesh	रिकेश
Reema	रीमा
Reena	रीना
Reesav	रिसाव
Reeshav	ऋषव
Reeshi	रेशी
Reeta	रीता
Reetik	रीतिक
Reewaj	रिवाज
Regal	रीगल
Regan	रेगन
Regesh	रेगेस
Regmi	रेग्मी
Regmim	रेग्मी
Rehgen	रेहगेन
Reja	रेजा
Rejar	रेजर
Rejina	रेजिना
Rejish	रेजिस
Rekha	रेखा
Rem	रेम
Reman	रेमन
Remant	रिमान्ट
Renij	रेनिज
Renish	रेनिस
Renjan	रेन्जन
Renu	रेणु
Renuka	रेणुका
Research	अनुसन्धान
Reshab	पुनर्स्थापना
Resham	रेशम
Reshma	रेश्मा
Reshub	रिशब
Resmi	रेस्मि
Revat	रेवत
Revati	रेवती
Rewant	Rewant
Rewat	रेवत
Rewati	रेवती
Reyaz	रियाज
Reyazul	रियाजुल
Reyn	रेन
Rheecha	रिचा
Rhitan	रितान
Rhitwik	ऋत्विक
Rhythm	लय
Ribek	रिबेक
Ribesh	रिबेश
Richa	रिचा
Richan	रिचन
Richard	रिचर्ड
Ricken	रिकेन
Rickesh	रिकेश
Riddhi	रिद्धि
Ridesh	सवारी
Ridhi	रिधि
Rijal	रिजाल
Rijan	रिजन
Rijen	रिजेन
Rijesh	रिजेश
Riju	रिजु
Rijun	रिजुन
Rikesh	रिकेश
Rikheswor	रिखेश्वर
Rikhi	रिकी
Rima	रिमा
Rimal	रिमाल
Rina	रिना
Rinesh	रिनेश
Rinkesh	रिंकेश
Rinku	रिंकु
Rip	रिप
Ripendra	रिपेन्द्र
Ripesh	रिपेश
Ripsu	रिप्सु
Ripu	रिपु
Risab	रिसाब
Risedeep	उदयदीप
Rishab	ऋषभ
Rishabh	ऋषभ
Rishan	रिसान
Rishap	रिसाप
Rishav	ऋषव
Rishi	ऋषि
Rishikesh	ऋषिकेश
Rishiraj	ऋषिराज
Rishma	रिश्मा
Rishu	ऋषु
Ritendra	रितेन्द्र
Ritesh	रितेश
Riti	रिति
Ritika	रितिका
Ritikesh	ऋतिकेश
Ritish	रितिश
Ritu	रितु
Rituraj	ऋतुराज
Riva	रिभा
Riwaj	रिवाज
Riwaz	रिवाज
Rizal	रिजाल
Rizbi	रिज्बी
Rmesh	रमेश
Roban	रोबन
Robi	रबि
Robin	रोबिन
Robins	रोबिन्स
Robinson	रोबिन्सन
Robus	रोबस
Rochak	रोचक
Rockey	रकी
Rocky	रकी
Rodan	रोडन
Rodesh	रोडेश
Rodhan	रोधन
Rodip	रोदिप
Rohan	रोहन
Roheet	रोहित
Rohil	रोहिल
Rohin	रोहिन
Rohini	रोहिणी
Rohit	रोहित
Roisha	रोइशा
Roja	रोजा
Rojal	शाही
Rojan	रोजन
Rojen	रोजेन
Rojesh	रोजेश
Rojin	रोजिन
Rojina	रोजिना
Rojit	रोजित
Rokesh	रोकेश
Rokin	रोकिन
Roma	रोमा
Romaj	रोमज
Roman	रोमन
Romarsh	रोमर्स
Romas	रोमस
Romi	रोमी
Romin	रोमिन
Romit	रोमित
Romiyo	रोमियो
Rona	रोना
Ronaj	रोनाज
Ronak	रोनक
Ronal	रोनाल्ड
Ronas	रोनास
Ronast	रोनास्ट
Ronesh	रोनेश
Ronik	रोनिक
Roniksh	रोनिक
Ronish	रोनिस
Ronit	रोनित
Roop	रुप
Roopesh	रुपेश
Rosan	रोसन
Rosemin	रोजमिन
Roshak	रोशक
Roshan	रोशन
Roshani	रोशनी
Roshanrakesh	रोशन राकेश
Roshendra	रोशेन्द्र
Roshi	रोशी
Roshish	रोशिस
Roshni	रोशनी
Rosish	गुलाब
Roushan	रौशन
Rovich	रोभिच
Roy	रोय
Royal	शाही
Rozan	रोजान
Rubal	रुबल
Ruban	रुबान
Rubash	रुबास
Ruben	रुबेन
Rubesh	रुबेश
Rubi	रुबी
Rubik	रुबिक
Rubin	रुबिन
Rubru	रुब्रु
Ruby	रुबी
Ruchendra	रुचेन्द्र
Ruchi	रुची
Ruchika	रुचिका
Ruchin	रुचिन
Rudra	रुद्र
Rudraraj	रुद्रराज
Rujal	रुजल
Rujan	रुजन
Rujen	रुजेन
Rujesh	रुजेश
Rujhan	रुझान
Rujjal	रुज्जल
Rujjwal	रुज्जवल
Rukesh	रुकेश
Rukmagat	रुक्मागत
Ruksan	रुक्सान
Rukshan	रुक्सान
Ruman	रुमन
Rumesh	रुमेश
Rumi	रुमी
Rumit	रुमित
Rumus	रुमस
Rup	रु
Rupa	रुपा
Rupak	रुपक
Rupal	रुपल
Rupan	रुपन
Rupas	रुपस
Rupendra	रुपेन्द्र
Rupesh	रुपेश
Rupika	रुपिका
Rupsen	रुपसेन
Rushal	रुसल
Rushan	रुशन
Rushil	रुशिल
Rushit	रुषित
Rushwin	रुसविन
Ruskin	रस्किन
Russell	रसेल
Rustam	रुस्तम
Rustom	रुस्तम
Saahil	साहिल
Saajan	साजन
Saakar	साकर
Saaket	साकेत
Saawan	सावन
Sabal	सबल
Sabalraj	सबलराज
Sabbir	सब्बीर
Sabbiu	Sabbiu
Sabdasen	शब्दसेन
Sabeen	सबीन
Sabi	सबी
Sabil	सबिल
Sabin	सबिन
Sabina	सबिना
Sabindra	सविन्द्र
Sabir	साबिर
Sabit	सबित
Sabita	सविता
Sabitri	सावित्री
Sabrin	सबरीना
Sabu	साबु
Sacchyam	सच्यम्
Sachchidanand	सच्चिदानन्द
Sachchidananda	सच्चिदानन्द
Sacheen	सचिन
Sachendra	सचेन्द्र
Sachet	झोला
Sachham	सचम
Sachhyam	सच्यम्
Sachi	साचि
Sachida	सचिदा
Sachidanand	सचिदानन्द
Sachidananda	सचिदानन्द
Sachin	सचिन
Sachina	सचिन
Sachindra	सचिन्द्र
Sachis	सचिस
Sachit	सचित
Sachitanand	सचितानन्द
Sachyam	सच्यम
Sadaf	सदफ
Sadam	सद्दाम
Sadan	सदन
Sadanand	सदानन्द
Sadananda	सदानन्द
Sadar	सदर
Saddam	सद्दाम
Sadeep	सदिप
Sadesh	सदेश
Sadhana	साधना
Sadhuram	साधुराम
Sadikshya	सदिक्षा
Sadip	सदिप
Sadish	सदिश
Sadit	सादित
Sadrish	सदरीश
Safal	सफाल
Safar	सफार
Safdar	सफदर
Safix	सेफिक्स
Sagar	सागर
Sagaurav	सगौरव
Sagoon	सगुन
Sagun	सगुन
Sagyan	सज्ञान
Sah	साह
Sahabuddin	साहबुद्दीन
Sahadeb	सहदेब
Sahadev	सहदेव
Sahaj	सहज
Sahan	सहन
Sahara	सहारा
Sahas	साहस
Sahash	सहस
Sahayog	सहयोग
Sahel	सहेल
Sahem	सहेम
Sahi	साही
Sahib	साहिब
Sahil	साहिल
Sahina	साहिना
Sahishnu	सहिष्णु
Sahit	साहित्य
Sahodar	सहोदर
Sahul	साहुल
Saideep	साईदीप
Saiet	बस्नुहोस्
Sailab	सैलाब
Sailendra	शैलेन्द्र
Sailesh	शैलेश
Sailish	सेलिस
Saiman	साइमन
Sainik	सैनिक
Sainju	सेन्जु
Saipal	साइपाल
Sairas	सायरस
Sajag	सजग
Sajal	सजल
Sajan	सजन
Sajana	सजना
Sajat	सजत
Sajay	सजय
Sajeeb	सजीब
Sajeen	सजीन
Sajeena	सजिना
Sajeet	सजित
Sajeev	सजीव
Sajen	सजेन
Sajendra	सजेन्द्र
Sajesh	सजेश
Sajib	सजिब
Sajid	साजिद
Sajil	सजिल
Sajin	सजिन
Sajit	सजित
Sajjan	सज्जन
Sajju	सज्जु
Saju	साजु
Sajun	सजुन
Sakal	सकल
Sakar	सक्कर
Sakat	सकट
Sakcham	सक्चम
Saket	साकेत
Sakhil	सखिल
Sakil	सकिल
Sakin	सकिन
Sakriya	सक्रिया
Sakroj	सकरोज
Saksham	साक्षम
Sakshamata	साक्षामाता
Sakshat	साक्षात्
Sakshm	Sakshm
Sakshyam	सक्षम
Salan	सलान
Saleen	सलीन
Saligram	सालिग्राम
Salik	सालिक
Salikram	शालिकराम
Salil	सलिल
Salim	सलीम
Salin	सलाइन
Salina	सालिना
Salinda	सालिन्दा
Salman	सलमान
Salon	सैलुन
Saloni	सलोनी
Salu	नमस्ते
Samal	सामल
Saman	समन
Samana	सामना
Samanta	सामन्था
Samar	समर
Samarajya	सामराज्य
Samardhan	समर्धन
Samarpan	समर्पण
Samarthya	सामर्थ्य
Samata	समता
Samba	साम्बा
Sambad	सम्वाद
Sambandha	सम्बंध
Sambardhan	सम्वर्धन
Sambat	सम्वत
Sambed	साम्बेड
Sambeg	सम्बेग
Sambhav	सम्भाव
Sambhu	शम्भु
Sambid	सम्बिड
Sambit	सम्बिट
Sambriddha	सम्वृद्ध
Sambriddhi	सम्वृद्धि
Sameeksha	समीक्षा
Sameen	समीन
Sameep	समिप
Sameer	समीर
Samel	सेमेल
Samey	सामी
Sami	सामी
Samiksha	समिक्षा
Samikshya	समिक्षा
Samil	सामिल
Samin	समीन
Samina	समिना
Samindra	समिन्द्र
Samip	सामिप
Samipya	सामिप्य
Samir	समीर
Samiran	समीरन
Samis	सामिस
Samish	समिश
Samit	शिखर सम्मेलन
Samita	समिता
Samiulla	समिउल्ला
Samjhana	सम्झना
Samman	सम्मान
Sammit	शिखर सम्मेलन
Sammriddha	समृद्धि
Samoj	समोज
Samooondra	समुन्द्रा
Sampanna	सम्पन्ना
Sampat	सम्पत
Samprash	सम्प्रस
Sampresh	सम्प्रेश
Sampurna	सम्पुर्ण
Samrakchan	सम्राकचन
Samrakshak	संरक्षक
Samrat	सम्राट
Samriddha	समृद्धि
Samriddhi	समृद्धि
Samridha	समृद्धा
Samridhi	समृद्धि
Samrit	सम्रित
Samse	सामसे
Samshad	सम्शाद
Samsher	समशेर
Samson	शिमसन
Samudhbhav	समुद्भव
Samuel	शमूएल
Samundra	समुन्द्र
Samunnat	समुन्नत
Samya	साम्या
Samyak	सम्यक
Samyam	संयम
Samyek	सम्यक
Samyog	सम्योग
Samyukta	संयुक्ता
Sanad	सनद
Sanam	सनम
Sanat	सन्त
Sanchar	संचार
Sanchaya	सञ्चय
Sanchu	साँचु
Sandarbha	सन्र्दभ
Sandeep	सन्दिप
Sandep	सन्दिप
Sandesh	सन्देश
Sandhya	सन्ध्या
Sandil	सन्दिल
Sandip	सन्दिप
Sangam	संगम
Sangbu	साङ्बु
Sange	साङ्गे
Sangeet	संगीत
Sangharsh	संघर्ष
Sangharsha	सङ्घर्ष
Sangin	सांगिन
Sangit	संगित
Sangita	संगिता
Sangya	संग्या
Sangyak	संग्याक
Sangye	सांगे
Sanij	सानिज
Sanil	सनिल
Sanim	सनिम
Sanip	सानिप
Sanir	सनिर
Sanish	सनिश
Sanit	सन्त
Sanjal	संजल
Sanjan	सञ्जन
Sanjay	सञ्जय
Sanjaya	सञ्जय
Sanjee	सञ्जी
Sanjeeb	सञ्जीव
Sanjeel	सञ्जिल
Sanjeep	सञ्जीप
Sanjeesh	सञ्जीश
Sanjeet	सञ्जित
Sanjeeta	सञ्जिता
Sanjeev	संजीव
Sanjesh	सञ्जेश
Sanjib	संजिब
Sanjil	सञ्जिल
Sanjip	संजिप
Sanjit	संजित
Sanjita	सञ्जिता
Sanjiv	संजीव
Sanjivan	संजीवन
Sanjog	संजोग
Sanjok	सन्जोक
Sanjot	सन्जोत
Sanju	सञ्जु
Sanjya	सञ्जय
Sankalan	सङ्कलन
Sankalp	संकल्प
Sankalpa	संकल्प
Sankar	शंकर
Sanker	शङ्कर
Sanket	सङ्केत
Sanny	सन्नी
Sano	सानो
Sanoj	सनोज
Sansar	संसार
Sanskar	संस्कार
Sanskriti	संस्कृत
Sant	सन्त
Santa	सान्ता
Santhosh	सन्तोष
Santosh	सन्तोष
Santoshi	सन्तोषी
Santwana	सन्ताना
Sanu	सानु
Sanuj	सानुज
Sanukaji	सानुकाजी
Sanullah	सानुल्लाह
Sanyam	सन्यम
Sanyog	संयोग
Sanyukta	संयुक्ता
Sapan	सपन
Sapana	सपना
Sapath	सपथ
Saphal	सफल
Sapin	सापिन
Sapkota	सापकोटा
Saput	सपुत
Sarad	सारा
Sarada	शारदा
Saraf	सराफ
Saragam	सारगम
Saraju	साराजेभो
Saral	सरल
Sarams	सरम
Saramsh	सरमश
Saramsha	सरम्शा
Saran	सारा
Saranga	सारङ्गा
Saransh	सारांश
Saras	सरस
Saraswati	सरस्वती
Saratendra	सरतेन्द्र
Sarb	सर्ब
Sarbagya	सर्बग्या
Sarbagyan	सर्वज्ञान
Sarbajeet	सर्वजित
Sarbej	सर्वेज
Sarbesh	सर्वेश
Sarbeshwar	सर्वेश्वर
Sarbin	सार्बिन
Sarbindra	सर्वविन्द्र
Sarbjit	सर्वजित
Sarbotkrist	सर्वोत्कृष्ट
Sarbottam	सर्वोत्तम
Sardul	सार्दुल
Saresh	सरेश
Sarif	सरिफ
Sarik	सारिक
Sarin	सरिन
Sarina	सरिना
Sarit	सरित
Sarita	सरिता
Sarjal	सर्जल
Sarjan	सर्जेन्ट
Sarju	सरजु
Sarman	सरमान
Sarobar	सरोबर
Saroj	सरोज
Saroja	सरोजा
Sarokar	सरोकार
Sarovar	सरोवर
Sarowar	सरोवर
Sarozh	सरोज
Sarphullah	सरफुल्लाह
Sarsij	सार्सिज
Sarthak	सार्थक
Saru	सारा
Sarun	सरुन
Sarup	सरूप
Sarvagya	सर्वज्ञ
Sarvendra	सर्वेन्द्र
Sarvesh	सर्वेश
Sarveshwar	सर्वेश्वर
Sarwajna	सर्वजना
Sarwan	सर्वन
Sasank	सासङ्क
Saseena	ससीना
Sashank	शशांक
Sashant	सशान्त
Sashi	शशि
Sashit	सशित
Sasin	ससिन
Sasit	ससित
Saswat	सास्वत
Saswot	सस्वत
Satan	शैतान
Satchit	सचित
Satendra	सतेन्द्र
Satish	सतीश
Satit	सतित
Satkar	सतकर
Satomi	सातोमी
Satrohan	सत्रोहन
Satrughan	शत्रुघन
Satsang	सत्संग
Satya	सत्य
Satyadev	सत्य देव
Satyam	सत्यम
Satyan	सत्यन
Satyanarayan	सत्यनारायण
Satyarth	सत्यार्थ
Satyen	सत्येन
Satyendra	सत्येन्द्र
Saubhagya	सौभाग्य
Saugat	सौगात
Sauhar	सौहर
Sauharda	सौहार्द
Saujan	सौजन
Saujanya	सौजन्या
Saumya	सौम्या
Saundarya	सौन्दर्या
Sauraab	सौराब
Saurab	सौरभ
Saurabh	सौरभ
Saurav	सौरभ
Saurya	सौर्य
Savan	सावन
Saveen	सविन
Savin	सेविन
Savya	सव्या
Sawal	सवल
Sawan	सावन
Sawant	सावन्त
Sayal	सायल
Sayan	सायन
Sayujya	सायुज्या
Sbir	Sbir
Season	सिजन
Sebak	सेबक
Sebi	सेबी
Sechan	सेचन
Seejan	सिजन
Seema	सीमा
Sejal	सेजल
Sekhar	शेखर
Selendra	सेलेन्द्र
Seman	सीमन
Semanta	सेमन्त
Senesh	सेनेश
Series	शृङ्खला
Serish	सेरिस
Serox	सेरोक्स
Servesh	सर्भेस
Seshkanta	शेषकान्त
Seteman	सेटम्यान
Sevok	सेभोक
Sewak	सेवक
Sewan	सेवान
Sewanta	सेवन्त
Sewas	सेवा
Shabba	शब्बा
Shabin	शबिन
Shacheendra	शचेन्द्र
Shachitra	शचित्र
Shadananda	षडानन्द
Shadev	छादेव
Shah	शाह
Shahabuddin	शाहबुद्दीन
Shahadev	शाहदेव
Shahanwaz	शाहनवाज
Shahas	शाहस
Shahi	शाही
Shahid	शाहिद
Shahil	शाहिल
Shahrukh	शाहरुख
Shailaj	शैलज
Shailaja	शैलजा
Shailandra	शैलेन्द्र
Shailendra	शैलेन्द्र
Shailes	शैलेस
Shailesh	शैलेश
Shailu	शैलु
Shaishab	शैशब
Shaishav	शैशव
Shaiush	शयुष
Shajan	शाजन
Shakar	शकर
Shakeel	शकील
Shakep	शेकप
Shakil	शकिल
Shakir	शाकिर
Shakta	शाक्त
Shakti	शक्ति
Shaktim	शक्तिम
Shakya	शाक्य
Shalabh	शलभ
Shaleen	शालीन
Shaligram	शालिग्राम
Shalik	शालिक
Shalom	शालोम
Shalyk	शालिक
Shambhoo	शम्भु
Shambhu	शम्भु
Shambu	शम्भु
Shameem	शमीम
Shamesh	शमेश
Shamim	शमीम
Shamir	शमिर
Shamser	शमशेर
Shamshad	शमशाद
Shamsher	शमशेर
Shamvab	शम्भव
Shamvu	शम्वु
Shamyujen	शामयुजेन
Shandar	शान्डर
Shangay	सांघाई
Shangharsha	सांघर्ष
Shanjeev	सञ्जीव
Shanjib	शान्जिब
Shankalpa	शंकल्प
Shankar	शंकर
Shanker	शंकर
Shanket	शङ्केत
Shankr	शंकर
Shanshray	शान्श्रय
Shant	शान्त
Shanta	शान्ता
Shantam	शान्तम
Shantanu	शान्तनु
Shanti	शान्ति
Shantosh	सन्तोष
Shapath	शपथ
Shaphal	शफल
Sharad	शरद
Sharada	शारदा
Sharal	सरल
Sharamnsha	शरमन्शा
Sharan	शरण
Sharat	शरत
Sharawan	शरावन
Sharbajit	शर्बजित
Sharban	शर्बान
Sharda	शारदा
Shardul	शार्दुल
Sharma	शर्मा
Sharman	शर्मन
Sharmila	शर्मिला
Sharnam	शरणम
Sharon	शेरोन
Sharthak	शार्थक
Sharwan	शरवन
Shasank	शशांक
Shasanka	शशांक
Shashank	शशांक
Shashanka	शशांक
Shashi	शशि
Shashidhar	शशिधर
Shashikant	शशिकान्त
Shashindra	शशिन्द्र
Shashwat	शाश्वत
Shashwot	शाश्वत
Shaswat	शास्वत
Shatrudhan	शत्रुधन
Shatrughan	शत्रुघ्न
Shaujan	शौजन
Shaurab	शौरब
Shaurabh	शौरभ
Shaurav	शौरव
Shawant	शवन्त
Shayam	श्याम
Shayan	शायन
Shayar	शायर
Shayarrn	शायरन
Shayush	शयुष
Sheela	शीला
Sheetal	शितल
Sheikh	शेख
Shekh	शेख
Shekhar	शेखर
Sher	शेर
Sherchan	शेरचन
Sheri	शेरी
Sherjung	शेरजुङ
Shesan	शेसन
Shesh	शेष
Shesha	शेषा
Shib	शिब
Shiba	शिबा
Shibam	शिबम
Shibendra	शिवेन्द्र
Shibir	शिबिर
Shibu	शिबु
Shiddhartha	सिद्धार्थ
Shiddi	शिद्दी
Shidhanta	शिधान्त
Shijan	शिजन
Shikab	शिकाब
Shikha	शिखा
Shikhar	शिखर
Shikshit	शिक्षा
Shikshya	शिक्षा
Shila	शिला
Shilan	शिलान
Shilpa	शिल्पा
Shir	शिर
Shiraj	सिराज
Shirendra	शिरेन्द्र
Shiris	शिरिस
Shirish	शिरीष
Shiro	शिरो
Shiromani	शिरोमणि
Shirshak	शिर्षक
Shisham	शिशम
Shishir	शिशिर
Shishu	शिशु
Shishupal	शिशुपाल
Shisif	शिसिफ
Shisir	शिशिर
Shisupal	शिसुपाल
Shital	शितल
Shittal	शितल
Shiv	शिव
Shiva	शिव
Shivahari	शिवहरी
Shivajee	शिवाजी
Shivaji	शिवाजी
Shivam	शिवम्
Shivanand	शिवानन्द
Shivani	शिवानी
Shivaraj	शिवराज
Shivaram	शिवराम
Shivaschan	शिवस्चन
Shivashankar	शिवशंकर
Shivasis	शिवशिस
Shivendra	शिवेन्द्र
Shivesh	शिवेश
Shivganga	शिवगंगा
Shivjee	शिवजी
Shivji	शिवजी
Shivnath	शिवनाथ
Shivraj	शिवराज
Shivsagar	शिवसागर
Shiw	शि
Shiwangi	शिवांगी
Shiwani	शिवानी
Shiwasreet	शिवश्रीत
Shlesha	श्लेशा
Shlok	श्लोक
Shneha	स्नेहा
Shoaib	शोएब
Shobha	शोभा
Shobhakar	शोभाकर
Shobhan	शोभन
Shobhanandan	शोभानन्दन
Shobhit	शोभित
Shobit	शोबिट
Shomesh	शोमेश
Shonu	शोनु
Shosit	शोसित
Shourav	शौरव
Shov	शोभ
Shova	शोभा
Shovakant	शोभाकान्त
Shovakhar	शोभाखर
Shovan	शोभन
Shovansing	शोभान्सिङ
Shovik	शोभिक
Shovit	शोभित
Shoviyat	शोभियत
Showet	शोएट
Shraban	श्रावण
Shrabesh	श्रवेश
Shrabin	श्रबिन
Shrabya	श्रव्य
Shraddha	श्राद्ध
Shradhye	श्रद्धा
Shrajesh	श्रजेश
Shrameeka	श्रमिक
Shramik	श्रमिक
Shranchev	श्रान्चेभ
Shravan	श्रावण
Shrawak	श्रावक
Shrawan	श्रावण
Shray	श्रेय
Shrayan	श्रयन
Shree	श्री
Shreebatsa	श्रीबत्सा
Shreedev	श्रीदेव
Shreedhar	श्रीधर
Shreedip	श्रीदीप
Shreejal	श्रीजल
Shreejan	श्रीजन
Shreejana	श्रीजना
Shreejesh	श्रीजेश
Shreejit	श्रीजित
Shreejung	श्रीजुङ
Shreekanta	श्रीकान्त
Shreekar	श्रीकर
Shreekrishna	श्रीकृष्ण
Shreekumar	श्रीकुमार
Shreelal	श्रीलाल
Shreeniwas	श्रीनिवास
Shreeram	श्रीराम
Shreesh	श्रीस
Shreeshanta	श्रीशान्त
Shreeson	श्रीसन
Shreesti	श्रेष्टी
Shreeya	श्रीया
Shreeyans	श्रीयांस
Shreeyash	श्रीयश
Shresth	श्रेष्ठ
Shrestha	श्रेष्ठ
Shrey	श्री
Shreya	श्रेया
Shreyam	श्रेयाम
Shreyansh	श्रेयांश
Shreyas	श्रेयस
Shreyash	श्रेयस
Shri	श्री
Shriaarjan	श्रीरञ्जन
Shrijal	श्रीजल
Shrijan	श्रीजन
Shrijendra	श्रीजेन्द्र
Shrijit	श्रीजित
Shriju	श्रीजु
Shrikant	श्रीकान्त
Shrikantha	श्रीकण्ठ
Shrikrishna	श्रीकृष्ण
Shringa	श्रृङ्गा
Shrinid	श्रीनिद
Shrisan	श्रीसन
Shrisha	श्रीशा
Shrishti	सृष्टि
Shristi	सृष्टि
Shritik	श्रृतिक
Shriwal	श्रीवाल
Shrma	श्रीमा
Shrong	क्रोङ
Shrutee	श्रुती
Shruti	श्रुति
Shrwan	श्रावण
Shshanka	शशाङ्क
Shshil	श्शिल
Shubash	शुभाश
Shubh	शुभ
Shubha	शुभा
Shubham	शुभम
Shubhash	शुभाश
Shubhashish	शुभाशिष
Shubhechchha	शुभेच्छ
Shubhekch	शुभेच्छ
Shubhendra	शुभेन्द्र
Shubhendu	शुभेन्दु
Shubhesh	शुभेश
Shukla	शुक्ला
Shukra	शुक्र
Shulab	शुलाब
Shulav	शुलाभ
Shulaxan	शुलाक्सन
Shusam	सुसम
Shusanta	सुशान्त
Shushant	सुशान्त
Shushanta	सुशान्त
Shushil	सुशील
Shushobhan	सुशोभन
Shushovan	सुशोभन
Shusil	शुसिल
Shusuhang	सुसुहाङ
Shuv	शुभ
Shuva	शुभ
Shuvam	शुभम
Shuvanjan	शुभान्जन
Shuvaraj	शुभराज
Shuvaschan	शुवास्चन
Shuvash	शुभाश
Shuvashis	शुवाशिस
Shuvashna	शुवाश्ना
Shuveksha	शुभेक्षा
Shuvra	शुभ्रा
Shweta	श्वेता
Shwetambar	श्वेताम्बर
Shyam	श्याम
Shyamanand	श्यामानन्द
Shyamhari	श्यामहरी
Shyamji	श्यामजी
Sibendra	सिबेन्द्र
Sibesh	सिबेश
Sichan	सिचन
Sichhit	सिचित
Siddant	सिद्धान्त
Siddanta	सिद्धान्त
Siddartha	सिद्धार्थ
Siddha	सिद्ध
Siddhant	सिद्धान्त
Siddhanta	सिद्धान्त
Siddharh	सिद्धार्थ
Siddharth	सिद्धार्थ
Siddhartha	सिद्धार्थ
Siddhi	सिद्धि
Siddiq	सिद्दिक
Sidharth	सिद्धार्थ
Sidhartha	सिद्धार्थ
Sidio	सिडियो
Sijan	सिजन
Siju	सिजु
Sikandar	सिकन्दर
Sikendra	सिकेन्द्र
Sikesh	सिकेश
Sikha	सिखा
Sikindar	सिकन्दर
Silan	सिलान
Silex	सिलेक्स
Silvia	सिल्भिया
Sima	सिमा
Simant	सिमन्त
Simanta	सिमन्त
Simaran	सिमरण
Simit	सिमित
Simon	साइमन
Simona	सिमोना
Simpi	सिम्पी
Simul	सिमुल
Sinet	सिनेट
Singh	सिंह
Sinjan	सिन्जन
Sira	सिरा
Siraj	सिराज
Sirap	सिरप
Sirapa	सिरापा
Sirees	सरहरू
Siris	सिरिस
Sirish	सिरिश
Sirjan	सिरजन
Sirjana	सिर्जना
Sirnivas	सिरनिवास
Siroj	सिरोज
Sirshak	सिरशाक
Sisal	सिसल
Sisam	सिसम
Sishir	शिशिर
Sisir	सिसिर
Sita	सीता
Sital	सीतल
Sitaram	सीताराम
Sitashma	सीताश्मा
Sitendra	सितेन्द्र
Sitesh	सितेश
Sittal	सित्तल
Siwin	सिविन
Sixit	सिक्सिट
Siya	सिया
Siyanand	सियानन्द
Sizar	सिजर
Skanda	स्कन्द
Sky	आकाश
Smaran	स्मरण
Smart	स्मार्ट
Smit	स्मिथ
Smita	स्मिता
Smith	स्मिथ
Smrit	स्मृति
Smriti	स्मृति
Sneha	स्नेहा
Soban	सोबन
Sobhan	शोभन
Sobhit	शोभित
Sobi	सोबी
Sobin	सोबिन
Sobit	सोबिट
Sobita	शोविता
Sofiya	सोफिया
Sohadra	सोहद्रा
Sohaib	सोहेब
Sohail	सोहेल
Sohan	सोहन
Sohel	सोहेल
Sohil	सोहिल
Sojan	सोजन
Sokrin	सोक्रिन
Solendra	सोलेन्द्र
Som	सोम
Soma	सोमा
Somat	सोमाट
Someshwor	सोमेश्वर
Somit	सोमित
Somjang	सोमजाङ
Sona	सोना
Sonal	सोनल
Sonalal	सोनाल
Sonali	सोनाली
Sonam	सोनम
Sonelal	सोनेलाल
Soni	सोनी
Sonic	सोनिक
Sonik	सोनिक
Sonika	सोनिका
Sonish	सोनिक
Sonit	सोनित
Soniya	सोनिया
Sonu	सोनु
Sonup	सोनप
Sony	सोनी
Soorya	सूर्या
Sopan	सोपान
Sophiya	सोफिया
Soragh	सोराघ
Soraj	सोराज
Soroj	सोरोज
Sorup	सिरप
Sougat	सौगात
Sourabh	सौरभ
Sourav	सौरभ
Souvenir	स्मारिका
Sovakant	सोभ्याकन्ट
Sovakanta	सोवकान्त
Sovas	सोभास
Sovin	सोभिन
Sovit	सोभियत
Sowan	सोवन
Soyal	सोयाल
Soyam	सोयम
Soyuz	सोयुज
Sp	Sp
Spad	कुदाल
Spandan	स्पन्दन
Sparsha	स्पर्श
Srawan	श्रावण
Sreevastav	श्रीवास्तव
Sri	श्री
Sridhar	श्रीधर
Srija	श्रीजा
Srijal	श्रीजल
Srijan	श्रीजन
Srijana	सृजना
Srijeet	सृजित
Srikant	श्रीकान्त
Sriram	श्रीराम
Srishan	श्रीशन
Srishti	सृष्टि
Sristi	सृष्टि
Sristy	सृष्टि
Srizan	श्रीजान
Sroj	सृज
Stalin	स्टालिन
Stip	स्टिप
Stya	स्ट्या
Suba	सुबा
Subahs	सुबास
Suban	सुबान
Subaran	सुवरन
Subarana	सुबराना
Subarn	सबर्न
Subarna	सुवर्णा
Subas	सुवास
Subash	सुवास
Subay	सुबे
Subba	सुब्बा
Subed	सुबेद
Subedi	सुवेदी
Subeg	सुबेग
Subek	सुबेक
Subekchhan	सुबेकचन
Suben	सुबेन
Subesh	सुबेस
Subha	सुभा
Subham	सुभम
Subhamrit	सुभमृत
Subhan	सुभान
Subhanjan	शुभजन
Subharaj	सुभराज
Subhas	सुभाष
Subhash	सुभाष
Subhashish	शुभाशिष
Subhav	सुभव
Subhay	सुभय
Subhekshya	शुभेक्ष्य
Subhoshan	सुभोशन
Subid	सुबिद
Subigya	सुबिग्या
Subij	सुबिज
Subik	सुबिक
Subikhyat	सुविख्यात
Subin	सुबिन
Subina	सुविना
Subindra	सुबिन्द्र
Subir	सुवीर
Subiran	सुबिरान
Subish	सुबिस
Subit	सबिट
Subodh	सुबोध
Subrat	सुब्रत
Subrath	सुब्रथ
Subritt	सुब्रिट
Sucharu	सुचारु
Suchita	सुचिता
Suchitra	सुचित्रा
Sudan	सुडान
Sudarsan	सुदर्शन
Sudarshan	सुदर्शन
Sudeen	सुदिन
Sudeep	सुदीप
Sudeepa	सुदिपा
Sudep	सुदीप
Sudersan	सुदरसन
Sudershan	सुदर्शन
Sudesh	सुदेश
Sudeshana	सुदेशना
Sudhakar	सुधाकर
Sudhan	सुधन
Sudhanshu	सुधांशु
Sudhansu	सुधांसु
Sudhar	सुधर
Sudharshan	सुदर्शन
Sudheer	सुधीर
Sudheesh	सुधीश
Sudhindra	सुधीन्द्र
Sudhir	सुधीर
Sudib	सुदिब
Sudil	सुदिल
Sudin	सुदिन
Sudip	सुदीप
Sudipt	सुदिप्त
Sudish	सुदिश
Sudisha	सुदिशा
Sudist	सुडिस्ट
Sudixit	सुदिक्षित
Sufiyan	सुफयान
Sugal	सुगल
Sugam	सुगम
Sugambar	सुगम्बर
Sugan	सुगन
Sugandh	सुगन्ध
Sugandha	सुगन्धा
Sugat	सुगत
Suhan	सुहान
Suhel	सुहेल
Suhim	सुहिम
Suhit	सुहित
Suhrid	सुहृद
Suhrit	सुहृत
Sujah	सुजाह
Sujal	सुजल
Sujan	सुजन
Sujana	सुजना
Sujang	सुजाङ
Sujanraj	सुजनराज
Sujash	सुजास
Sujata	सुजाता
Sujay	सुजय
Sujaya	सुजय
Sujeen	सुजीन
Sujeet	सुजित
Sujendra	सुजेन्द्र
Sujesh	सुजेश
Sujil	सुजिल
Sujin	सुजिन
Sujina	सुजिना
Sujindra	सुजिन्द्र
Sujish	सुजिश
Sujit	सुजित
Sujita	सुजिता
Sujiv	सुजीव
Suk	सुक
Sukadev	सुकदेव
Sukarma	सुकर्मा
Sukdev	सुकदेव
Sukesh	सुकेश
Sukh	सुख
Sukhad	सुखद
Sukra	सुक्र
Sukraman	सुक्रमान
Sukrit	सुकृत
Sulab	सुलाब
Sulabh	सुलभ
Sulata	सुलता
Sulav	सुलाभ
Sulaxana	सुलक्साना
Sulen	सुलेन
Sulochan	सुलोचन
Sulok	सुलोक
Sulove	सुलोभ
Sulson	सुलसन
Suman	सुमन
Sumana	सुमना
Sumanraj	सुमनराज
Sumant	सुमन्त
Sumantu	सुमन्तु
Sumarga	सुमार्गा
Sumat	सुमत
Sumati	सुमती
Sumedh	सुमेध
Sumeet	सुमित
Sumendra	सुमेन्द्र
Sumeru	सुमेरु
Sumesh	सुमेश
Sumin	सुमिन
Sumina	सुमिना
Sumir	सुमिर
Sumish	सुमिश
Sumit	सुमित
Summima	सुम्मिमा
Summit	शिखर सम्मेलन
Summon	बोलाउनुहोस्
Sumod	सुमोद
Sumoda	सुमोडा
Sumun	सुमन
Sunaina	सुनैना
Sunam	सुनम
Sunanda	सुन्दा
Sunav	सुनव
Sunayan	सुनयन
Sundar	सुन्दर
Sundaram	सुन्दरम
Sundeep	सन्दीप
Sunder	सुन्दर
Sundip	सन्दिप
Suneel	सुनिल
Sunetra	सुनेत्रा
Sunil	सुनिल
Sunim	सुनिम
Sunir	सुनिर
Sunish	सन्नी
Sunit	सुनित
Sunita	सुनिता
Sunjeev	सञ्जीव
Sunny	सन्नी
Sunoj	सुनोज
Supendra	सुपेन्द्र
Suprabha	सुप्रभा
Suprajna	सुप्रज्ञा
Suprem	सर्वोच्च
Supreme	सर्वोच्च
Suprim	सर्वोच्च
Suprince	सुप्रिन्स
Supriya	सुप्रिया
Suput	सुप्ट
Surabhi	सुरभी
Surag	सुराग
Suraj	सुरज
Surajkumar	सुरजकुमार
Surakshit	सुरक्षित
Surakshya	सुरक्षा
Suramya	सुरम्या
Suranjan	सुरन्जन
Surash	सुरेश
Surav	सुरव
Suraz	सुराज
Suren	सुरेन
Surendra	सुरेन्द्र
Suresh	सुरेश
Surin	सुरिन
Surit	सुरत
Surja	सुर्य
Surjan	सुरजन
Suroj	सुरोज
Surojan	सुरोजन
Suruchi	सुरुचि
Surya	सुर्य
Suryadev	सूर्यदेव
Susaan	सुसान
Susan	सुसान
Susant	सुसेन्ट
Susat	सुसात
Sushagya	सुशाग्या
Susham	सुशम
Sushan	सुसान
Sushank	सुशांक
Sushant	सुशान्त
Sushanta	सुशान्त
Susheel	सुशील
Sushib	सुशिब
Sushil	सुशील
Sushila	सुशीला
Sushim	सुशिम
Sushma	सुष्मा
Sushmit	सुस्मित
Sushmita	सुस्मिता
Sushovan	सुशोभन
Sushrusha	सुश्रुषा
Sushrut	सुश्रुत
Susil	सुसिल
Susim	सुसिम
Susma	सुस्मा
Susmeet	सुस्मित
Susmin	सुस्मिन
Susmit	सुस्मित
Susmita	सुस्मिता
Susmriti	सुस्मृति
Susobik	सुसोबिक
Suson	सुसान
Sussan	सुसान
Sustam	सुस्तम
Suvaichchha	सुवैच्छ
Suvam	सुभम
Suvash	सुवास
Suvendra	सुभेन्द्र
Suvesh	सुवेश
Suvrat	सुव्रत
Suwal	सुवाल
Suwan	सुवान
Suwarn	सुवर्न
Suwarna	सुवर्ण
Suwash	सुवास
Suyam	सुयम
Suyan	सुयान
Suyash	सुयश
Suyen	सुयेन
Suyesh	सुयश
Suyog	सुयोग
Suyogya	सुयोग
Suza	सुजा
Suzeet	सुजित
Suzit	सुजित
Suzu	सुजु
Swadesh	स्वदेश
Swadheen	स्वाधीन
Swadhin	स्वाधीन
Swagan	स्वागन
Swagat	स्वागत
Swain	स्वेन
Swapnil	स्वप्निल
Swaraj	स्वराज
Swarnim	स्वर्णिम
Swarup	स्वरूप
Swarupa	स्वरूपा
Swasti	स्वस्ति
Swastik	स्वस्तिक
Swastika	स्वस्तिक
Swatantra	स्वतन्त्र
Swati	स्वाती
Swaviman	स्वाभिमान
Swayabhu	स्वयभु
Swayam	स्वयम
Swayambhu	स्वयम्भू
Swechchha	स्वेच्छ
Sweekar	साता
Sweta	स्वेता
Swikar	स्विकार
Swikrit	स्विकृत
Swikriti	स्विकृति
Swochhal	स्वछल
Swodesh	स्वदेश
Swodha	स्वोधा
Swonil	स्वोनिल
Swonti	स्वान्ति
Swopnil	स्वप्निल
Swornil	स्वर्णिल
Swornim	सपथ
Sworup	स्वरूप
Swostik	स्वोस्टिक
Swotantra	स्वतन्त्र
Swoyambhu	स्वयम्भू
Swoyuj	स्वयुज
Syed	सैयद
Sylvina	सिल्भिना
Tabassum	तबस्सुम
Tahir	ताहिर
Tahira	ताहिरा
Tak	हो
Takdir	भाग्य
Takman	Takman
Tako	त्यसैले
Talank	तालङ्क
Talat	तलत
Talaz	तलाज
Taman	तमन
Tamanna	तमन्ना
Tamot	Tamot
Tamrakar	ताम्राकार
Tamundeshwor	तमुण्डेश्वर
Tanbir	तनवीर
Tanchhowpa	तनछाउपा
Tanjir	तन्जिर
Tank	ट्याङ्की
Tanka	टन्का
Tankar	टङ्कर
Tanoj	तनोज
Tansen	तानसेन
Tanuj	तनुज
Tanuk	तनुक
Tanus	तानुस
Tanya	तान्या
Tapaeshwar	तपेश्वर
Tapan	तपन
Tapaswini	तपस्विनी
Tapasya	तपस्या
Tapendra	तपेन्द्र
Tapta	तप्त
Tara	तारा
Taranand	तारानन्द
Taranath	तारानाथ
Taranga	तरङ्गा
Tarani	तरानी
Tarique	तारिक
Tark	टार्क
Tarka	तारका
Tarkeshwor	तारकेश्वर
Tarun	तरुण
Tarzan	टार्जन
Tashi	टाशी
Tasi	Tasi
Taufik	तौफिक
Tauqeer	तौकीर
Taya	ताया
Tej	तेज
Teja	तेजा
Tejan	तेजन
Tejas	तेजस
Tejash	तेजस
Tejashwi	तेजस्वी
Tejasvi	तेजस्वी
Tejaswee	तेजस्वी
Tejaswi	तेजस्वी
Tejendra	तेजेन्द्र
Tejesh	तेजेश
Tejindra	तेजिन्द्र
Tejlal	तेजलाल
Tejnath	तेजनाथ
Tejraj	तेजराज
Tek	प्राविधिक
Tekendra	टेकेन्द्र
Telisha	तेलिशा
Temba	टेम्बा
Tendi	टेन्डी
Tenzing	तेन्जिङ
Thagendra	ठगेन्द्र
Thakur	ठाकुर
Thal	थल
Thalbir	थालबिर
Tham	थाम
Thaman	थमन
Thamma	थम्मा
Thaneshor	थानेशोर
Thaneshwar	थानेश्वर
Thaneswar	थानेश्वर
Thapa	थापा
Thapaliya	थपलिया
Tharendra	थारेन्द्र
Thark	थार्क
Thesis	थीसिस
Thir	थिर
Thiralal	तिरालाल
Thirtha	तिर्थ
Thorang	थोराङ
Thumb	औंठा
Thusitha	थुसिथा
Tidan	टिडान
Tika	टिका
Tikam	टिकम
Tikaprem	टिकाप्रेम
Tikaram	टिकाराम
Tilak	तिलक
Timilsina	तिमिल्सिना
Timothi	तिमोथी
Tiresh	टायरेस
Tirpeshwar	तिरपेश्वर
Tirth	तीर्थ
Tirtha	तीर्थ
Tiwari	तिवारी
Tobindra	तोबिन्द्र
Tol	टोल
Tom	टम
Toni	टोनी
Tonil	टोनिल
Tony	टोनी
Top	शीर्ष
Topendra	टोपेन्द्र
Toran	तोरान
Torchi	टर्च
Toshak	तोषक
Toshika	तोशिका
Toya	टोया
Toyanath	टोयानाथ
Toznath	तोजनाथ
Tranish	ट्र्यानिस
Tri	त्रि
Tribendra	त्रिवेन्द्र
Tribeni	त्रिवेणी
Tribhuban	त्रिभुवन
Tribhuvan	त्रिभुवन
Tribhuwan	त्रिभुवन
Tribikram	त्रिविक्रम
Trideep	त्रिदीप
Tridev	त्रिदेव
Trilochan	त्रिलोचन
Trilok	त्रिलोक
Triloki	त्रिलोकी
Trimik	त्रिमिक
Trinetra	त्रिनेत्र
Tripti	त्रिप्ति
Tripurari	त्रिपुरारी
Triratna	त्रिरत्न
Trisam	त्रिसम
Trnsfer	ट्रान्सफर
Tsering	Tsering
Tshering	छिरिङ
Tufail	तुफैल
Tuk	टुक
Tul	तुल
Tula	तुला
Tuladhar	तुलाधर
Tulajang	तुलाजाङ
Tulakanta	तुलकान्त
Tularam	तुलाराम
Tulashi	तुलसी
Tulasi	तुलसी
Tulshi	तुलसी
Tulsi	तुलसी
Tulsing	तुलसिङ
Tulsiram	तुलसीराम
Tumul	तुमुल
Tung	तुङ
Tupesh	तुपेश
Tuphan	तुफान
Tusar	तुषार
Tushar	तुषार
Uchit	उचित
Udairam	उदयराम
Uday	उदय
Udaya	उदय
Udbodh	उदबोध
Uddab	उदब
Uddav	उद्धव
Uddeshya	उदेश्य
Uddhab	उद्धव
Uddhav	उद्धव
Udeep	उदीप
Udesh	उदेश
Udgar	उद्गार
Udhab	उधब
Udhyam	उध्यम
Udichi	उदिची
Udin	उदिन
Udip	उदिप
Udit	उदित
Ugan	उगान
Ugendra	युगेन्द्र
Ugesh	उगेश
Ugra	उग्रा
Ujawal	उज्वल
Ujen	उजेन
Ujit	उजित
Ujja	उज्जा
Ujjain	उज्जैन
Ujjal	उज्जल
Ujjan	उज्जन
Ujjawal	उज्जवल
Ujjwal	उज्जवल
Ujjwan	उज्जवन
Ujjwol	उज्वोल
Ujwal	उज्वल
Ujwol	उज्वोल
Ujyol	उज्योल
Ukee	उकी
Ukesh	उकेश
Ullash	उल्लास
Uma	उम्मा
Umakant	उमाकान्त
Umang	उमंग
Umanga	उमंगा
Umar	उमर
Umashankar	उमाशंकर
Umesh	उमेश
Umeshanand	उमेशानन्द
Umeshwor	उमेश्वर
Umid	उमिद
Unam	उनम
Unique	अद्वितीय
Unish	युनिस
Unmesh	उन्मेश
Upadesh	उपदेश
Upadhya	उपाध्याय
Upadhyaya	उपाध्याय
Upahar	उपहार
Upaj	उपज
Upakar	उपकार
Upanshu	उपांशु
Upasak	उपासक
Updesh	उपदेश
Upen	उपेन
Upendra	उपेन्द्र
Upesh	उपेश
Urbin	Urbino
Uren	युरेन
Urina	युरिना
Urisha	उरिशा
Urusha	उरुषा
Usan	उसान
Usha	उषा
Ushab	उषभ
Ushal	उशाल
Ushan	उशन
Uthkristha	उत्कृष्ठ
Utkal	उत्कल
Utkarsa	उत्कर्ष
Utkarsh	उत्कर्ष
Utkarsha	उत्कर्ष
Utkrishta	उत्कृष्ठ
Utkrist	उत्क्रिष्ट
Utkrista	उत्कृष्ट
Utsab	उत्सव
Utsarga	उत्सर्ग
Utsav	उत्सव
Utsavraj	उत्सवराज
Utshab	उत्सब
Utshav	उत्सव
Utsuk	उत्सुक
Uttam	उत्तम
Uttar	उत्तरा
Uzen	उजेन
Uzzwal	उज्वल
Vabendra	वबेन्द्र
Vabish	वाबिस
Varun	वरुण
Vasanta	वसन्त
Vasudev	वासुदेव
Vawesh	वावेश
Ved	वेद
Veer	वीर
Veeru	वीरु
Vesh	भेस
Veshram	वेश्राम
Vhima	भिमा
Viajay	विजय
Vibek	Vibek
Vibhash	विभास
Vibhav	विभव
Vibhu	विभु
Vibhushan	विभूषण
Vickey	विक्की
Vicky	विक्की
Victor	भिक्टर
Vidhan	विधान
Vidya	विद्या
Vidyaman	विद्यामान
Vidyanand	विद्यानन्द
Vijay	विजय
Vijaya	विजया
Vijayendra	विजयेन्द्र
Vijendra	विजेन्द्र
Vikal	विकल
Vikalpa	विकास
Vikas	विकास
Vikash	विकास
Vikram	विक्रम
Vikrant	विक्रान्त
Vilas	विलास
Vimal	विमल
Vinay	विनय
Vinaya	विनय
Vinayak	विनायक
Vinod	विनोद
Vipul	विपुल
Vishal	विशाल
Vishama	विशामा
Vishan	विशान
Vishesh	विशेष
Vishma	विष्मा
Vishnu	विष्णु
Vishwa	विश्व
Vishwambhar	विश्वम्भर
Vishwaprakash	विश्वप्रकाश
Vishwo	विश्व
Vision	दृष्टि
Vitam	भिटामिन
Vivash	Vivash
Vivek	विवेक
Vivekanand	विवेकानन्द
Vivid	जीवन्त
Viwek	भिवेक
Vrishav	वृषभ
Wahab	वहाब
Walpole	वालपोल
Washim	वाशिम
Wasim	वसीम
Wasnik	वासनिक
Watan	वतन
William	विलियम
Willing	इच्छुक
Wrishav	वृषभ
Yaban	याबान
Yachu	याचु
Yadab	यादब
Yadav	यादव
Yadbendra	यादबेन्द्र
Yadin	यादिन
Yadu	यदु
Yagan	यागन
Yagartha	यगर्थ
Yageraj	यागेराज
Yagya	यज्ञ
Yahosu	Yahoo!
Yajan	यजन
Yajna	यज्ञ
Yaju	यजु
Yam	याम
Yaman	यमन
Yamendra	यमेन्द्र
Yamon	यामन
Yamu	यमु
Yamuna	यमुना
Yanish	यानिस
Yas	हो
Yash	यश
Yasha	यश
Yashasvi	यशस्वि
Yashaswi	यशस्वी
Yashbin	यशबिन
Yashovardhan	यशोवर्धन
Yashpal	यशपाल
Yashu	यशु
Yashwant	यशवन्त
Yashworya	यशोर्य
Yasin	यासिन
Yateendra	यतिेन्द्र
Yathest	यथेस्ट
Yatra	यात्रा
Yawan	यवन
Yeemlesh	यमलेश
Yeju	येजु
Yemjee	यम्जी
Yengina	येङ्गिना
Yesh	हो
Yijendra	यिजेन्द्र
Yobaraj	योबराज
Yobin	योबिन
Yog	योग
Yoga	योग
Yogendra	योगेन्द्र
Yogesh	योगेश
Yogeshwar	योगेश्वर
Yogeshwor	योगेश्वर
Yogi	योगी
Yogindra	योगिन्द्र
Yojan	योजना
Yoman	योमन
Yookesh	योकेश
Youb	Youb
Youbaraj	युवराज
Younesh	युनेश
Yu	यु
Yuaan	युआन
Yuajen	युजेन
Yub	युब
Yuba	युबा
Yubak	युबक
Yuban	युबान
Yubaraj	युवराज
Yubarat	युबरात
Yuben	युबेन
Yubraj	युवराज
Yubranjan	युब्रञ्जन
Yuddha	युद्ध
Yudeep	युदीप
Yudhir	युधिर
Yudhisthir	युधिष्ठिर
Yudip	युदिप
Yug	युग
Yugal	युगल
Yugank	युगाङ्क
Yugant	युगान्त
Yugantar	युगान्तर
Yugdip	युगदीप
Yugeen	युगीन
Yugen	युगेन
Yugesh	युगेश
Yugsagar	युगसागर
Yujeen	यूजीन
Yujesh	युजेश
Yujin	यूजीन
Yuke	युके
Yukesh	युकेश
Yuki	युकी
Yukta	युक्ता
Yukti	युक्ति
Yunik	युनिक
Yunika	युनिका
Yunish	युनिस
Yunisha	युनिशा
Yuraj	युराज
Yuresh	युरेश
Yuroj	युरोज
Yushef	युसेफ
Yushma	युष्मा
Yusna	युस्ना
Yuv	युव
Yuva	युवा
Yuvaraj	युवराज
Yuvraj	युवराज
Yuwaraj	युवराज
Yuyutshu	युयुत्शु
Yuyutsu	युयुत्सु
Yuzan	युजान
Zaheer	जहीर
Zakki	जक्की
Zenish	जेनिस
Zenith	जेनिथ
Zenithar	जेनिथर
Ziaul	जियाउल
Zigar	चुरोट
Zippy	जिप्पी